state_name,district_name,"upto_two_year
s",used_for_breeding_only,used_for_agricultur,agriculture_and_breeding,bullock_cart_farm_operations,others_male,total_male,under_one_year,one_to_three_years,in_milk,dry,not_calved_once,others_female,total_female,total
Andaman And Nicobar Islands,Nicobars,3,3,1,15,0,0,22,5,5,8,7,2,0,27,49
Andaman And Nicobar Islands,North And Middle Andama,129,213,737,493,14,31,1617,161,140,303,362,20,14,1000,2617
Andaman And Nicobar Islands,South Andamans,120,33,42,73,12,3,283,154,159,258,150,28,2,751,1034
Andhra Pradesh,Anantapur,11294,2041,3516,1145,2038,948,20982,65192,49388,100956,32483,11465,4977,264461,285443
Andhra Pradesh,Chittoor,5936,728,480,327,345,289,8105,19077,15162,28976,10323,4124,913,78575,86680
Andhra Pradesh,East Godavari,18318,4178,4463,2568,1774,789,32090,130448,106411,222035,59254,23288,11720,553156,585246
Andhra Pradesh,Guntur,44182,4531,4293,2157,1210,1519,57892,192258,177602,291477,81452,46755,34911,824455,882347
Andhra Pradesh,Krishna,37579,3741,2434,1724,644,1273,47395,149715,138161,229374,67708,26352,11068,622378,669773
Andhra Pradesh,Kurnool,17525,1523,2153,966,845,471,23483,94466,78167,144410,56960,16919,5450,396372,419855
Andhra Pradesh,Prakasam,47484,5503,4175,1782,1486,1995,62425,219263,185619,327197,81722,33232,17193,864226,926651
Andhra Pradesh,Spsr Nellore,46371,4889,2415,1485,1194,1750,58104,173734,143801,249185,81503,28167,11335,687725,745829
Andhra Pradesh,Srikakulam,4108,650,1804,791,1186,147,8686,9374,7220,15751,4377,2575,498,39795,48481
Andhra Pradesh,Visakhapatanam,15423,3491,16107,2780,1356,762,39919,68480,60139,108867,24942,11643,4856,278927,318846
Andhra Pradesh,Vizianagaram,7431,1441,5744,1928,1249,1056,18849,28472,24333,42566,11506,6642,3490,117009,135858
Andhra Pradesh,West Godavari,27776,4629,3727,2246,1585,1560,41523,142066,117553,224535,55629,29098,17505,586386,627909
Andhra Pradesh,Y.S.R.,34668,3044,2110,1502,1071,1374,43769,107808,91292,161366,54278,20962,7106,442812,486581
Arunachal Pradesh,Changlang,186,104,149,17,13,9,478,92,118,87,45,27,2,371,849
Arunachal Pradesh,East Kameng,10,1,0,1,0,9,21,2,3,26,1,1,10,43,64
Arunachal Pradesh,East Siang,22,7,100,6,20,17,172,4,27,4,28,13,24,100,272
Arunachal Pradesh,Lohit,193,48,212,79,43,48,623,137,149,261,160,105,31,843,1466
Arunachal Pradesh,Lower Dibang Valley,139,24,194,17,6,22,402,170,189,316,163,105,22,965,1367
Arunachal Pradesh,Lower Subansiri,17,5,0,0,0,0,22,13,22,11,6,2,0,54,76
Arunachal Pradesh,NAMSAI,6,0,11,0,0,0,17,2,11,4,27,0,0,44,61
Arunachal Pradesh,Papum Pare,159,141,150,152,140,145,887,112,132,152,112,100,136,744,1631
Arunachal Pradesh,Tawang,0,0,0,0,2,0,2,0,0,0,0,0,0,0,2
Arunachal Pradesh,Upper Subansiri,67,43,58,0,0,16,184,67,68,121,52,65,23,396,580
Arunachal Pradesh,West Kameng,2,3,0,0,0,0,5,1,1,2,2,0,0,6,11
Assam,BAKSA,91,19,197,5,1,7,320,149,150,127,55,9,3,493,813
Assam,BONGAIGAON,138,50,94,25,201,5,513,155,130,287,130,10,15,727,1240
Assam,Barpeta,2468,1356,1638,558,707,134,6861,4056,3332,4117,1561,540,162,13768,20629
Assam,Biswanath,1755,478,1405,1076,94,102,4910,2028,1691,2792,1083,487,117,8198,13108
Assam,Cachar,4215,838,7676,2766,330,374,16199,9790,8727,9186,5364,726,455,34248,50447
Assam,Chirang,162,11,318,140,252,14,897,198,113,276,166,94,1,848,1745
Assam,DARRANG,4483,3278,4762,2061,728,252,15564,6107,5724,6384,2255,658,378,21506,37070
Assam,DHEMAJI,1754,498,1424,374,95,1067,5212,2191,1951,4113,2218,853,116,11442,16654
Assam,DHUBRI,971,312,1068,233,237,62,2883,2258,2678,2406,1995,147,60,9544,12427
Assam,Dibrugarh,1818,611,1280,306,125,543,4683,1988,1426,2406,1058,381,591,7850,12533
Assam,Dima Hasao,5526,849,4494,1094,1360,2551,15874,4829,4722,4423,956,902,2362,18194,34068
Assam,Goalpara,1229,369,1389,343,229,197,3756,1679,718,1589,329,163,297,4775,8531
Assam,Golaghat,1671,1142,5856,778,459,543,10449,3820,3866,8610,2211,893,700,20100,30549
Assam,Hailakandi,1436,360,3444,220,114,108,5682,3503,3250,3696,2249,563,272,13533,19215
Assam,Hojai,101,36,118,23,11,3,292,235,271,259,87,58,19,929,1221
Assam,Jorhat,2630,776,1513,539,259,118,5835,4291,4056,4934,1633,156,192,15262,21097
Assam,Kamrup,1005,106,981,88,375,86,2641,1169,798,1627,734,84,23,4435,7076
Assam,Kamrup (M),170,31,59,15,15,9,299,165,115,273,75,15,11,654,953
Assam,Karbi Anglong,401,104,906,366,67,10,1854,627,254,947,142,44,16,2030,3884
Assam,Karimganj,2588,611,4046,1035,241,184,8705,4536,5450,6265,1904,496,174,18825,27530
Assam,Kokrajhar,631,313,2443,312,211,66,3976,878,632,1242,853,191,61,3857,7833
Assam,Lakhimpur,1209,371,1357,364,38,167,3506,2049,1620,3054,888,404,145,8160,11666
Assam,Majuli,564,164,664,87,3,34,1516,1165,886,1536,571,172,399,4729,6245
Assam,Morigaon,652,216,431,128,54,18,1499,852,796,822,244,55,49,2818,4317
Assam,Nagaon,1815,1333,1817,877,777,640,7259,2157,2205,2822,1100,349,412,9045,16304
Assam,Nalbari,742,697,333,61,432,46,2311,981,640,1257,438,145,42,3503,5814
Assam,Sibsagar,1367,205,967,199,27,231,2996,3534,1970,3969,1432,558,370,11833,14829
Assam,Sonitpur,647,153,815,113,90,117,1935,1303,1219,1535,895,200,75,5227,7162
Assam,Soraideu,115,4,142,5,0,4,270,153,133,183,157,19,1,646,916
Assam,South Salmara,596,215,571,166,459,66,2073,731,604,866,143,47,84,2475,4548
Assam,Tinsukia,1094,971,1467,519,51,41,4143,1185,1519,1654,1024,130,92,5604,9747
Assam,Udalguri,180,120,237,232,38,27,834,397,681,630,82,46,47,1883,2717
Assam,West Karbi Anglong,1140,265,1199,843,57,105,3609,1580,962,1500,733,379,64,5218,8827
Bihar,Araria,9210,3258,3005,1405,1392,2023,20293,50815,51231,61012,20993,4555,5562,194168,214461
Bihar,Arwal,1631,244,225,47,47,45,2239,25640,15593,30565,11307,2090,651,85846,88085
Bihar,Aurangabad,7444,341,298,66,20,62,8231,46297,41608,61089,35040,3472,706,188212,196443
Bihar,Banka,5410,402,3838,606,135,237,10628,28045,23568,32960,13420,3019,486,101498,112126
Bihar,Begusarai,1074,256,254,186,44,43,1857,21544,19541,33097,8508,1192,669,84551,86408
Bihar,Bhagalpur,5556,1723,1465,2170,2193,2358,15465,58271,56493,71885,26914,11895,8745,234203,249668
Bihar,Bhojpur,5745,365,119,30,42,17,6318,61573,56859,90899,36328,7415,1198,254272,260590
Bihar,Buxar,2177,84,50,25,33,112,2481,39473,47925,47961,28703,3638,1566,169266,171747
Bihar,Darbhanga,5657,1957,1870,920,577,983,11964,95578,80334,95344,36181,5257,4257,316951,328915
Bihar,Gaya,16379,1592,6180,946,333,592,26022,75496,58980,100633,43842,11695,4249,294895,320917
Bihar,Gopalganj,1853,248,111,172,41,234,2659,26586,21333,26538,14425,1787,813,91482,94141
Bihar,Jamui,9844,3969,4909,3394,2458,2178,26752,27958,21191,35359,14948,3140,3171,105767,132519
Bihar,Jehanabad,6579,148,342,70,17,41,7197,29290,30603,40241,17157,789,198,118278,125475
Bihar,Kaimur (Bhabua),6199,353,348,469,97,335,7801,55862,39575,97416,30222,8633,3095,234803,242604
Bihar,Katihar,4532,1217,1642,526,500,243,8660,23330,19943,28826,11671,2576,739,87085,95745
Bihar,Khagaria,1818,424,321,160,207,176,3106,24506,19768,30488,11862,3487,842,90953,94059
Bihar,Kishanganj,6710,5286,5713,719,1177,471,20076,13246,9267,11998,3115,2733,495,40854,60930
Bihar,Lakhisarai,1011,103,94,56,46,34,1344,14344,12004,17353,8594,2317,897,55509,56853
Bihar,Madhepura,9481,990,1147,330,159,153,12260,59031,56460,65264,38348,7242,1722,228067,240327
Bihar,Madhubani,11984,3908,3846,1046,798,782,22364,130921,116408,142953,51761,12750,12149,466942,489306
Bihar,Munger,1736,334,544,96,33,39,2782,10333,8907,13790,6289,602,486,40407,43189
Bihar,Muzaffarpur,7523,1320,872,448,294,247,10704,81124,63617,94713,36484,7652,2274,285864,296568
Bihar,Nalanda,13428,966,1175,332,165,968,17034,73077,54217,95664,30951,7632,1285,262826,279860
Bihar,Nawada,8612,760,2359,638,337,479,13185,31118,25767,40900,18957,2334,855,119931,133116
Bihar,Pashchim Champaran,19252,3330,8490,3464,8708,785,44029,67961,49114,75276,29161,4863,2239,228614,272643
Bihar,Patna,7023,1520,1259,1085,857,976,12720,75570,62239,114951,49416,6449,4486,313111,325831
Bihar,Purbi Champaran,12217,1698,1108,551,285,535,16394,110438,68970,118024,48487,6860,3609,356388,372782
Bihar,Purnia,18558,6895,4587,1271,886,491,32688,59979,53979,63295,25400,5459,1865,209977,242665
Bihar,Rohtas,8500,988,352,110,41,121,10112,72593,82679,106083,50891,9979,3060,325285,335397
Bihar,Saharsa,8174,4522,2425,1543,1611,329,18604,54405,48312,57149,20860,4257,2763,187746,206350
Bihar,Samastipur,2261,528,246,248,92,121,3496,45363,42941,65470,30836,3767,1584,189961,193457
Bihar,Saran,2700,281,266,103,103,204,3657,44045,46248,62551,33997,2770,1573,191184,194841
Bihar,Sheikhpura,2928,158,273,57,29,184,3629,15858,10305,19833,4418,1350,1115,52879,56508
Bihar,Sheohar,906,73,70,33,62,21,1165,16670,12309,18214,6640,403,6411,60647,61812
Bihar,Sitamarhi,12551,4509,2687,1059,669,4697,26172,106632,76861,121948,35343,9302,5003,355089,381261
Bihar,Siwan,2257,410,582,380,334,522,4485,44863,37498,50945,22408,6620,8381,170715,175200
Bihar,Supaul,13726,2364,3017,893,532,663,21195,88315,67028,93175,33635,10966,12019,305138,326333
Bihar,Vaishali,1990,546,716,241,66,83,3642,43247,27351,59340,20857,4320,1905,157020,160662
Chandigarh,Chandigarh,629,75,0,2,11,2,719,2139,1032,7041,1189,37,20,11458,12177
Chhattisgarh,Balod,3505,382,7536,463,770,128,12784,3166,3590,4952,3996,1573,164,17441,30225
Chhattisgarh,Baloda Bazar,9027,529,8219,254,659,489,19177,7538,6660,11291,9634,2394,417,37934,57111
Chhattisgarh,Balrampur,4252,524,19633,869,188,360,25826,6768,4849,9431,6369,2492,376,30285,56111
Chhattisgarh,Bastar,1742,256,37393,1953,1259,112,42715,1270,1411,2339,1914,499,235,7668,50383
Chhattisgarh,Bemetara,6394,954,7121,424,2474,213,17580,7102,7128,10478,8459,3532,434,37133,54713
Chhattisgarh,Bijapur,1085,340,4013,1410,300,2,7150,1673,1350,2022,1643,881,2,7571,14721
Chhattisgarh,Bilaspur,10097,2814,29374,2580,2756,1137,48758,9408,8825,14521,10997,5333,451,49535,98293
Chhattisgarh,Dantewada,2028,93,7706,831,29,47,10734,1398,1208,1656,1928,561,85,6836,17570
Chhattisgarh,Dhamtari,5196,115,10138,105,819,127,16500,3889,5370,5857,5640,1746,105,22607,39107
Chhattisgarh,Durg,6315,1075,3410,97,214,410,11521,6800,5607,15588,8516,2974,116,39601,51122
Chhattisgarh,Gariyaband,3271,414,6524,222,278,49,10758,2832,3029,4551,4245,1508,108,16273,27031
Chhattisgarh,Janjgir-Champa,3375,436,13626,814,1011,393,19655,2981,2848,4462,3834,1720,302,16147,35802
Chhattisgarh,Jashpur,3229,189,11627,258,146,116,15565,2858,3100,4515,5632,1504,242,17851,33416
Chhattisgarh,Kabirdham (Kawardha),4018,1079,11504,976,560,224,18361,4253,3652,6121,4898,2482,323,21729,40090
Chhattisgarh,Kanker,1546,109,12440,152,890,108,15245,1306,888,1764,1950,375,30,6313,21558
Chhattisgarh,Kondagaon,1406,163,19161,841,72,64,21707,1514,1151,2107,2503,571,51,7897,29604
Chhattisgarh,Korba,4553,627,19557,2349,282,230,27598,4462,4152,7119,7053,2078,202,25066,52664
Chhattisgarh,Korea,4742,1699,23542,1652,917,293,32845,8740,7854,11237,7673,2488,727,38719,71564
Chhattisgarh,Mahasamund,3255,334,4487,74,227,229,8606,2764,2616,4351,3666,1131,103,14631,23237
Chhattisgarh,Mungeli,3764,198,7450,155,2561,126,14254,4208,4594,5292,6548,1838,166,22646,36900
Chhattisgarh,Narayanpur,1188,101,2559,5499,106,125,9578,1289,1390,1726,1837,693,164,7099,16677
Chhattisgarh,Raigarh,1582,128,13820,526,123,61,16240,1620,1472,2631,1741,605,25,8094,24334
Chhattisgarh,Raipur,8884,1247,1424,306,253,391,12505,9474,7346,18130,10796,4087,241,50074,62579
Chhattisgarh,Rajnandgaon,6489,539,22661,443,1554,752,32438,5085,5431,8934,6659,1916,369,28394,60832
Chhattisgarh,Sukma,2705,920,6072,1705,1127,621,13150,2712,2884,3090,1835,803,728,12052,25202
Chhattisgarh,Surajpur,4436,1317,39688,2613,404,381,48839,5109,4473,7091,6417,1535,231,24856,73695
Chhattisgarh,Surguja,5036,337,32075,751,35,113,38347,6582,3833,9463,8557,3210,189,31834,70181
Dadra And Nagar Haveli,Dadra And Nagar Haveli,163,14,30,9,5,2,223,125,96,413,128,12,0,774,997
Daman And Diu,Daman,22,5,3,7,5,12,54,29,35,121,127,8,0,320,374
Goa,North Goa,1235,413,337,219,3,89,2296,2080,1845,3859,1730,745,34,10293,12589
Goa,South Goa,1170,428,144,184,12,627,2565,2174,2295,4445,2350,544,245,12053,14618
Gujarat,AHMADABAD,11530,1423,185,217,131,236,13722,79291,73470,131676,64521,14817,4002,367777,381499
Gujarat,AMRELI,4978,427,368,69,30,75,5947,40001,34172,75145,19213,3529,780,172840,178787
Gujarat,ANAND,13253,1358,249,83,58,116,15117,85231,107500,183778,56456,11341,1437,445743,460860
Gujarat,ARVALLI,13782,425,242,42,5,9,14505,85215,75302,133985,62296,12534,971,370303,384808
Gujarat,BANAS KANTHA,76813,6519,1503,742,1065,1309,87951,298585,363512,524411,196808,26659,3611,1413586,1501537
Gujarat,BHARUCH,7108,1465,578,346,170,1295,10962,36350,30918,60016,19081,3851,1345,151561,162523
Gujarat,BHAVNAGAR,6635,969,410,266,78,143,8501,63463,57200,108020,44871,7157,2718,283429,291930
Gujarat,BOTAD,3584,356,150,52,15,387,4544,16424,16740,26273,9339,1441,355,70572,75116
Gujarat,CHHOTAUDEPUR,12981,135,450,46,9,50,13671,43242,36037,69322,41950,5275,199,196025,209696
Gujarat,DANG,1738,895,12121,76,2731,63,17624,1221,1753,1856,710,71,0,5611,23235
Gujarat,DEVBHUMI DWARKA,1597,762,292,114,143,169,3077,53686,53749,125549,39267,6535,2773,281559,284636
Gujarat,DOHAD,32232,8546,9163,5443,5558,5322,66264,105947,103848,146872,74018,18540,9032,458257,524521
Gujarat,GANDHINAGAR,11849,1074,90,32,5,163,13213,61655,59886,120246,44201,22410,963,309361,322574
Gujarat,GIR SOMNATH,3902,648,581,112,206,85,5534,45808,37242,78804,22285,2673,1612,188424,193958
Gujarat,JAMNAGAR,3628,757,254,16,14,18,4687,32874,30748,72852,18793,1945,434,157646,162333
Gujarat,JUNAGADH,6144,1037,147,37,22,223,7610,39420,40190,81072,30904,10883,1335,203804,211414
Gujarat,KACHCHH,23650,4798,205,73,88,1240,30054,92710,96490,163176,71692,9596,2623,436287,466341
Gujarat,KHEDA,22707,1194,600,183,71,1077,25832,115589,151274,208882,90685,21750,2148,590328,616160
Gujarat,MAHESANA,17550,3658,2361,1088,118,357,25132,95711,98556,192472,58142,17661,628,463170,488302
Gujarat,MORBI,5839,818,146,115,2,65,6985,38843,34374,65645,26653,2396,80,167991,174976
Gujarat,Mahisagar,10769,202,407,166,23,37,11604,79819,94488,149499,56663,12097,1833,394399,406003
Gujarat,NARMADA,7220,428,207,22,7,153,8037,13364,14597,22996,15515,1586,219,68277,76314
Gujarat,NAVSARI,3949,105,1559,26,3,31,5673,10535,11025,23751,7682,3085,114,56192,61865
Gujarat,PANCH MAHALS,11962,585,898,272,41,215,13973,92556,97008,150498,67863,9164,3402,420491,434464
Gujarat,PATAN,19223,1653,105,76,31,352,21440,82246,96054,149536,73893,9133,535,411397,432837
Gujarat,PORBANDAR,2854,357,155,42,34,32,3474,22272,27775,62010,22702,3458,1843,140060,143534
Gujarat,RAJKOT,7109,1009,133,44,28,114,8437,56125,51173,108276,33289,11250,506,260619,269056
Gujarat,SABAR KANTHA,10346,1297,1450,904,90,43,14130,90413,88977,156456,45861,19065,2106,402878,417008
Gujarat,SURAT,6857,1693,355,305,294,490,9994,48701,54047,98899,30935,6401,2071,241054,251048
Gujarat,SURENDRANAGAR,12314,1762,385,132,32,28,14653,69221,77671,117199,58942,11985,1240,336258,350911
Gujarat,TAPI,6061,389,669,41,14,288,7462,34748,38412,58873,31614,8491,1059,173197,180659
Gujarat,VADODARA,13494,1723,1261,143,53,216,16890,64500,70331,134149,44567,8112,1941,323600,340490
Gujarat,VALSAD,2864,380,13252,160,51,73,16780,8898,9519,21099,6382,1026,151,47075,63855
Haryana,AMBALA,7841,251,549,242,626,193,9702,27486,24472,53141,16796,5377,646,127918,137620
Haryana,BHIWANI,20212,485,279,93,65,537,21671,62221,69363,94113,20689,7311,2187,255884,277555
Haryana,CHARKI DADRI,10874,225,14,10,42,354,11519,33214,39379,52767,10830,4228,584,141002,152521
Haryana,FARIDABAD,4250,208,316,300,361,105,5540,26117,15750,48470,12263,3403,2557,108560,114100
Haryana,FATEHABAD,20100,553,53,25,39,372,21142,45194,62997,75593,21052,7493,419,212748,233890
Haryana,GURUGRAM,6133,148,136,36,2,149,6604,27902,17023,46194,11502,2167,812,105600,112204
Haryana,HISAR,35804,949,283,153,137,238,37564,93886,102174,142003,37512,11249,1458,388282,425846
Haryana,JHAJJAR,17124,367,42,65,43,372,18013,43172,36820,69924,8581,3709,240,162446,180459
Haryana,JIND,44001,809,1234,703,2278,370,49395,76851,89028,123988,40988,12108,1248,344211,393606
Haryana,KAITHAL,23596,558,2445,2188,1715,504,31006,58188,60503,91343,31215,8530,1102,250881,281887
Haryana,KARNAL,18386,331,1923,2483,1378,493,24994,38266,41867,67495,18978,8568,477,175651,200645
Haryana,KURUKSHETRA,12175,322,958,746,856,528,15585,25090,30207,45703,14954,6640,879,123473,139058
Haryana,MAHENDRAGARH,12804,119,32,35,42,274,13306,40767,45988,69450,12893,4275,528,173901,187207
Haryana,MEWAT,6834,326,229,134,92,215,7830,48502,26204,70187,14504,5214,1906,166517,174347
Haryana,PALWAL,14182,364,441,229,1078,192,16486,46308,30234,79915,20785,4827,936,183005,199491
Haryana,PANCHKULA,2235,108,43,16,4,44,2450,8876,11881,21249,9002,2273,297,53578,56028
Haryana,PANIPAT,17584,209,1997,1005,1786,834,23415,33194,31203,59466,13536,3572,781,141752,165167
Haryana,REWARI,11580,177,24,17,8,32,11838,36879,34788,62866,9503,4366,183,148585,160423
Haryana,ROHTAK,17722,416,165,195,178,113,18789,39481,33876,64492,12365,4789,364,155367,174156
Haryana,SIRSA,19329,658,74,69,43,301,20474,47746,63593,82649,23440,12100,693,230221,250695
Haryana,SONIPAT,20018,661,1097,755,1034,773,24338,49655,42067,83796,19982,4385,757,200642,224980
Haryana,YAMUNANAGAR,5594,193,956,457,321,180,7701,26305,23817,45379,17857,4260,819,118437,126138
Himachal Pradesh,Bilaspur,5324,234,18,54,9,152,5791,21240,18258,41573,10068,2359,225,93723,99514
Himachal Pradesh,Chamba,1031,317,47,37,11,19,1462,3891,3129,10919,4768,563,62,23332,24794
Himachal Pradesh,Hamirpur,4529,108,43,30,0,235,4945,18085,17223,47714,7144,1894,241,92301,97246
Himachal Pradesh,Kangra,9452,698,282,81,23,262,10798,23621,24840,51440,18592,3732,674,122899,133697
Himachal Pradesh,Kullu,42,49,0,1,0,0,92,180,190,554,245,40,0,1209,1301
Himachal Pradesh,Mandi,2884,238,52,8,1,83,3266,11516,8717,32433,6242,1500,182,60590,63856
Himachal Pradesh,Shimla,254,71,15,10,0,7,357,671,688,2924,766,183,14,5246,5603
Himachal Pradesh,Sirmaur,2682,154,116,16,2,74,3044,6501,6565,13186,5974,1246,322,33794,36838
Himachal Pradesh,Solan,2845,182,35,11,7,111,3191,13814,9889,32123,8952,2537,168,67483,70674
Himachal Pradesh,Una,8362,398,25,19,9,60,8873,21543,25209,44156,10177,2927,157,104169,113042
Jammu And Kashmir,Anantnag,225,33,17,9,0,48,332,399,231,1201,219,50,82,2182,2514
Jammu And Kashmir,Badgam,27,5,12,6,1,0,51,191,186,274,14,12,2,679,730
Jammu And Kashmir,Bandipora,53,28,5,31,0,0,117,75,89,396,88,28,1,677,794
Jammu And Kashmir,Baramulla,170,10,13,24,0,12,229,612,196,1246,201,44,14,2313,2542
Jammu And Kashmir,Doda,426,209,98,35,3,5,776,3439,2835,7929,2856,218,30,17307,18083
Jammu And Kashmir,Ganderbal,35,5,12,0,0,0,52,49,50,106,30,18,6,259,311
Jammu And Kashmir,Jammu,4210,799,451,467,338,143,6408,23342,19624,49949,18479,3983,1120,116497,122905
Jammu And Kashmir,Kathua,4163,1232,731,365,144,86,6721,13929,9911,25519,8511,1716,1149,60735,67456
Jammu And Kashmir,Kishtwar,199,169,224,45,27,0,664,1712,1029,3374,1206,198,33,7552,8216
Jammu And Kashmir,Kulgam,219,64,0,0,0,7,290,166,232,705,84,21,6,1214,1504
Jammu And Kashmir,Kupwara,136,55,23,48,1,2,265,435,365,795,297,86,8,1986,2251
Jammu And Kashmir,Leh Ladakh,0,0,0,0,0,0,0,0,0,0,0,0,0,0,0
Jammu And Kashmir,Poonch,1726,848,95,296,12,3,2980,26960,14281,53108,14097,2676,570,111692,114672
Jammu And Kashmir,Pulwama,76,20,7,2,0,0,105,69,56,493,71,0,0,689,794
Jammu And Kashmir,Rajauri,4490,1430,255,236,62,23,6496,34835,15829,66914,20297,3163,1049,142087,148583
Jammu And Kashmir,Ramban,1140,375,71,67,3,21,1677,5418,2564,7217,1640,526,197,17562,19239
Jammu And Kashmir,Reasi,1857,739,231,305,55,109,3296,18034,9255,25387,9307,1760,326,64069,67365
Jammu And Kashmir,Samba,1332,383,122,38,17,28,1920,5784,6510,10745,5046,320,44,28449,30369
Jammu And Kashmir,Shopian,290,32,0,0,0,30,352,493,203,1068,152,139,38,2093,2445
Jammu And Kashmir,Srinagar,3,2,1,0,0,0,6,29,6,64,22,2,2,125,131
Jammu And Kashmir,Udhampur,4165,800,1426,3322,19,114,9846,16597,10066,29742,11275,1579,820,70079,79925
Jharkhand,Bokaro,2344,455,11674,1215,357,134,16179,3401,2036,4913,1642,269,85,12346,28525
Jharkhand,Chatra,10206,5502,15476,4196,919,2445,38744,14132,13854,18283,11874,2513,2600,63256,102000
Jharkhand,Deoghar,4527,675,6439,832,170,1169,13812,8987,9811,13120,6520,883,1250,40571,54383
Jharkhand,Dhanbad,2241,274,2686,122,31,52,5406,5760,4225,12394,3050,1088,750,27267,32673
Jharkhand,Dumka,4535,1387,5366,1718,504,350,13860,9392,7937,10555,4760,1002,584,34230,48090
Jharkhand,East Singhbum,3546,5118,4904,1793,20184,248,35793,5145,5044,9934,1448,870,310,22751,58544
Jharkhand,Garhwa,3806,1363,3746,703,287,117,10022,17489,12535,23025,9289,1088,502,63928,73950
Jharkhand,Giridih,10308,4093,25848,7126,1820,1149,50344,15835,12910,22150,6943,3307,846,61991,112335
Jharkhand,Godda,3525,1084,1450,919,558,759,8295,24702,25768,27510,7606,968,1167,87721,96016
Jharkhand,Gumla,9431,455,32513,1356,182,707,44644,9823,9592,12560,11002,2525,334,45836,90480
Jharkhand,Hazaribagh,6228,1129,34509,1117,1000,587,44570,6111,5281,8381,5622,331,196,25922,70492
Jharkhand,Jamtara,1499,880,6175,1233,93,51,9931,2446,2433,3037,2236,297,40,10489,20420
Jharkhand,Khunti,3333,1150,9740,1186,683,329,16421,4227,3184,6037,2238,510,301,16497,32918
Jharkhand,Koderma,1693,980,7663,589,88,20,11033,2316,2195,4106,708,106,32,9463,20496
Jharkhand,Latehar,3786,626,8875,1185,255,180,14907,5307,4014,7720,4961,829,350,23181,38088
Jharkhand,Lohardaga,2275,76,3599,864,397,104,7315,2092,1773,4010,1098,353,124,9450,16765
Jharkhand,Pakur,8847,3677,6466,4436,3996,1311,28733,10296,8267,11146,4868,5872,1033,41482,70215
Jharkhand,Palamu,6878,1174,2788,465,100,234,11639,21498,17277,26375,14645,2131,877,82803,94442
Jharkhand,Ramgarh,1449,267,18402,1475,169,270,22032,1639,1193,2907,1169,161,60,7129,29161
Jharkhand,Ranchi,9698,2072,47026,8331,1032,806,68965,13184,11641,20529,7676,2021,1137,56188,125153
Jharkhand,Sahebganj,6461,651,4912,1993,104,71,14192,8365,6556,10093,5669,1526,144,32353,46545
Jharkhand,Saraikela Kharsawan,3159,670,14174,1407,1620,283,21313,2467,1414,3614,1365,290,290,9440,30753
Jharkhand,Simdega,2618,391,9736,861,84,357,14047,2460,2738,3690,2080,1329,256,12553,26600
Jharkhand,West Singhbhum,2826,698,13719,1684,597,498,20022,2515,1818,3693,2394,516,311,11247,31269
Karnataka,Bagalkot,8760,909,533,383,320,360,11265,58214,39041,76462,37958,9084,2316,223075,234340
Karnataka,Bangalore Rural,407,76,52,21,2,8,566,3940,2912,7716,1593,163,34,16358,16924
Karnataka,Belgaum,21075,1681,2069,375,226,227,25653,195332,128367,359958,108084,23376,3401,818518,844171
Karnataka,Bellary,5950,358,256,129,21,68,6782,27067,22251,42545,26052,2448,262,120625,127407
Karnataka,Bengaluru Urban,233,154,68,38,23,12,528,1949,3269,4571,618,186,47,10640,11168
Karnataka,Bidar,6843,375,237,57,17,40,7569,34504,13785,50912,15602,2865,273,117941,125510
Karnataka,Bijapur,3792,585,520,423,49,65,5434,48173,27829,73109,18634,3080,820,171645,177079
Karnataka,Chamarajanagar,611,73,26,3,0,47,760,2164,1871,3285,1365,180,293,9158,9918
Karnataka,Chikballapur,526,68,90,124,63,31,902,5303,4838,11752,3083,427,92,25495,26397
Karnataka,Chikmagalur,2729,431,387,147,9,40,3743,6671,5234,11723,5854,1049,88,30619,34362
Karnataka,Chitradurga,7016,513,283,42,27,160,8041,23535,16404,38806,20789,5127,602,105263,113304
Karnataka,Dakshin Kannad,234,136,223,19,5,77,694,259,285,391,165,22,16,1138,1832
Karnataka,Davangere,10594,545,162,167,6,160,11634,26134,17926,44468,18622,4462,350,111962,123596
Karnataka,Dharwad,3457,329,149,43,32,78,4088,13360,8572,24691,8055,2213,266,57157,61245
Karnataka,Gadag,1865,233,76,54,14,52,2294,14036,9653,19269,7370,2474,702,53504,55798
Karnataka,Gulbarga,3533,673,321,63,56,54,4700,18198,11873,27059,9612,1449,285,68476,73176
Karnataka,Hassan,4825,318,379,54,18,45,5639,24809,15473,45083,15511,1171,285,102332,107971
Karnataka,Haveri,4164,257,111,13,7,41,4593,20131,13413,32281,11961,2888,234,80908,85501
Karnataka,Kodagu,687,137,337,93,3,124,1381,830,799,1330,676,120,100,3855,5236
Karnataka,Kolar,455,36,31,10,27,9,568,4969,6255,11567,2735,336,90,25952,26520
Karnataka,Koppal,2203,323,154,94,19,115,2908,14732,10218,24271,9148,1840,350,60559,63467
Karnataka,Mandya,1789,152,54,18,7,49,2069,26094,16831,49880,13300,948,321,107374,109443
Karnataka,Mysore,869,77,98,13,5,172,1234,5331,2828,9011,2473,653,152,20448,21682
Karnataka,Raichur,3905,291,349,93,68,145,4851,25485,20089,36429,22317,2794,455,107569,112420
Karnataka,Ramanagara,638,46,5,3,2,4,698,4780,3363,8294,2299,115,95,18946,19644
Karnataka,Shimoga,12972,2030,2999,518,38,772,19329,20485,19210,33430,20553,6036,1520,101234,120563
Karnataka,Tumkur,5059,307,173,74,32,116,5761,32717,22865,56535,20724,2840,605,136286,142047
Karnataka,Udupi,214,35,904,42,8,43,1246,308,203,469,144,29,9,1162,2408
Karnataka,Uttar Kannad,7449,667,3747,729,46,217,12855,11996,12105,23743,9557,3501,236,61138,73993
Karnataka,Yadgir,3159,300,428,132,128,160,4307,13478,8835,17201,11101,1916,600,53131,57438
Kerala,Alappuzha,3812,23,26,18,13,139,4031,478,588,507,97,21,4,1695,5726
Kerala,Ernakulam,7728,52,44,45,28,607,8504,396,495,514,84,18,18,1525,10029
Kerala,Idukki,2889,31,46,19,0,138,3123,454,677,630,164,13,6,1944,5067
Kerala,Kannur,1837,12,10,1,16,98,1974,107,161,152,39,4,9,472,2446
Kerala,Kasaragod,920,9,160,22,13,78,1202,64,125,70,32,8,5,304,1506
Kerala,Kollam,7318,159,97,18,48,145,7785,301,248,266,43,5,10,873,8658
Kerala,Kottayam,4370,50,35,19,35,107,4616,387,611,401,135,13,0,1547,6163
Kerala,Kozhikode,3283,31,34,3,43,87,3481,120,205,90,17,2,0,434,3915
Kerala,Malappuram,12580,163,134,63,95,1086,14121,260,275,337,62,7,15,956,15077
Kerala,Palakkad,6944,69,157,53,69,351,7643,318,418,426,370,386,182,2100,9743
Kerala,Pathanamthitta,2491,52,34,10,2,87,2676,194,178,160,49,2,1,584,3260
Kerala,Thiruvananthapuram,3526,26,33,8,2,65,3660,333,285,659,76,20,8,1381,5041
Kerala,Thrissur,16212,90,58,115,118,546,17139,860,1247,942,234,70,28,3381,20520
Kerala,Wayanad,3549,46,114,30,39,160,3938,133,151,80,47,4,0,415,4353
Lakshadweep,Lakshadweep District,0,0,0,0,0,0,0,2,8,5,1,0,0,16,16
Madhya Pradesh,AGAR MALWA,10646,1606,394,275,31,91,13043,42684,21092,61386,19901,2912,624,148599,161642
Madhya Pradesh,ALIRAJPUR,4704,894,634,64,17,13,6326,17094,12616,19534,16202,1417,228,67091,73417
Madhya Pradesh,ANUPPUR,5468,462,22729,721,104,115,29599,8410,4938,12119,6582,1717,201,33967,63566
Madhya Pradesh,ASHOKNAGAR,11013,1670,84,62,140,372,13341,34180,22058,50107,22200,4415,669,133629,146970
Madhya Pradesh,BALAGHAT,17707,1775,34361,2560,1422,458,58283,30029,25370,40371,24885,6340,1527,128522,186805
Madhya Pradesh,BARWANI,6963,1700,1040,188,91,95,10077,29980,25162,43222,31579,3464,1133,134540,144617
Madhya Pradesh,BETUL,11272,2146,1874,349,345,383,16369,40030,30700,56753,23082,5047,1794,157406,173775
Madhya Pradesh,BHIND,18795,800,74,44,32,648,20393,104312,90366,152348,47161,8143,1507,403837,424230
Madhya Pradesh,BHOPAL,8573,1150,190,67,21,369,10370,24316,14720,45162,13205,3220,378,101001,111371
Madhya Pradesh,BURHANPUR,3173,1414,686,142,80,320,5815,10599,8912,17678,9048,1934,686,48857,54672
Madhya Pradesh,CHHATARPUR,28096,4586,1343,980,184,876,36065,90868,54108,127671,57750,25947,4945,361289,397354
Madhya Pradesh,CHHINDWARA,12286,2552,3072,541,234,147,18832,38901,25457,47125,29886,5104,1769,148242,167074
Madhya Pradesh,DAMOH,9029,2071,620,410,210,163,12503,28406,23087,43020,24971,3687,2044,125215,137718
Madhya Pradesh,DATIA,6323,1048,256,340,207,245,8419,77908,48735,97249,39491,10796,7456,281635,290054
Madhya Pradesh,DEWAS,13021,2667,1768,773,387,350,18966,58875,37971,98156,30793,3527,1050,230372,249338
Madhya Pradesh,DHAR,19066,1764,950,199,164,496,22639,63137,44917,91868,47879,6470,2599,256870,279509
Madhya Pradesh,DINDORI,4951,1657,11325,909,108,301,19251,10045,9999,12361,8712,1790,687,43594,62845
Madhya Pradesh,EAST NIMAR,8686,1393,620,478,93,345,11615,36356,28777,55525,26598,2574,8886,158716,170331
Madhya Pradesh,GUNA,22276,3670,1572,786,607,902,29813,68134,51156,99794,42528,6534,2945,271091,300904
Madhya Pradesh,GWALIOR,19465,2064,255,136,57,68,22045,65222,35109,106048,35286,3568,2205,247438,269483
Madhya Pradesh,HARDA,5846,920,93,36,29,31,6955,17949,16426,24713,15421,1915,532,76956,83911
Madhya Pradesh,HOSHANGABAD,6843,1169,280,88,52,137,8569,26566,20183,36276,17729,2500,527,103781,112350
Madhya Pradesh,INDORE,9165,2253,1218,486,384,77,13583,36071,20239,82623,16473,3785,420,159611,173194
Madhya Pradesh,JABALPUR,6804,1413,1112,123,74,269,9795,19177,14447,38203,15574,3601,801,91803,101598
Madhya Pradesh,JHABUA,9640,1236,716,70,25,47,11734,31095,20740,40610,25139,2870,462,120916,132650
Madhya Pradesh,KATNI,9316,2428,1536,628,614,517,15039,19638,15573,27416,15663,3119,1377,82786,97825
Madhya Pradesh,KHARGONE,11011,1876,1805,255,51,283,15281,54859,42920,102027,50067,7457,1886,259216,274497
Madhya Pradesh,MANDLA,6654,1205,24691,2112,69,275,35006,10612,8862,14176,10788,2174,480,47092,82098
Madhya Pradesh,MORENA,46710,2408,795,185,150,1870,52118,165746,129247,261048,64756,10820,1843,633460,685578
Madhya Pradesh,Mandsaur,14737,1851,157,96,25,499,17365,68395,35390,87238,37535,6089,2321,236968,254333
Madhya Pradesh,NARSINGHPUR,8359,921,237,70,64,203,9854,26447,22621,35584,19043,2907,228,106830,116684
Madhya Pradesh,NEEMUCH,14267,1511,401,201,33,295,16708,35896,28948,54135,28982,4619,458,153038,169746
Madhya Pradesh,PANNA,12828,3371,1726,3200,95,861,22081,46749,31502,60138,31754,4694,979,175816,197897
Madhya Pradesh,RAISEN,8046,1595,529,310,77,344,10901,33730,27814,42543,20558,2074,984,127703,138604
Madhya Pradesh,RAJGARH,19629,2165,501,126,88,109,22618,138633,73202,182679,54001,8008,3901,460424,483042
Madhya Pradesh,RATLAM,18104,1408,289,995,124,268,21188,42672,27918,66912,29649,3906,1192,172249,193437
Madhya Pradesh,REWA,14853,2269,869,397,126,230,18744,64610,51144,81005,36610,7154,2388,242911,261655
Madhya Pradesh,SAGAR,20029,4827,1024,675,451,806,27812,47766,37373,72499,41018,7634,1991,208281,236093
Madhya Pradesh,SATNA,16307,3984,1508,370,163,691,23023,57267,40407,76416,35677,7455,3908,221130,244153
Madhya Pradesh,SEHORE,10489,1594,786,158,137,410,13574,73182,45610,108945,29133,4424,1092,262386,275960
Madhya Pradesh,SEONI,12816,1246,4035,637,844,311,19889,23897,18395,31574,15674,3666,814,94020,113909
Madhya Pradesh,SHAHDOL,9405,1921,24637,2380,737,594,39674,18255,15075,24367,13507,3524,1435,76163,115837
Madhya Pradesh,SHAJAPUR,14155,887,145,43,20,51,15301,50792,33554,89138,18825,4350,1662,198321,213622
Madhya Pradesh,SHEOPUR,15873,3116,1226,894,333,79,21521,41568,33049,60944,30597,9567,1378,177103,198624
Madhya Pradesh,SHIVPURI,24590,5919,1446,414,147,1855,34371,98915,66662,138337,59357,11012,2354,376637,411008
Madhya Pradesh,SIDHI,10974,971,2224,888,128,537,15722,19567,19931,30776,18714,3875,1723,94586,110308
Madhya Pradesh,SINGRAULI,4884,1114,2190,307,43,134,8672,19347,13472,26347,11674,1360,367,72567,81239
Madhya Pradesh,TIKAMGARH,13559,2584,894,310,157,932,18436,84742,47755,102694,47238,12111,3170,297710,316146
Madhya Pradesh,UJJAIN,18100,3107,1157,652,169,161,23346,81806,49342,138732,47466,7664,3648,328658,352004
Madhya Pradesh,UMARIA,6243,856,2363,272,30,20,9784,11269,6180,14656,9129,499,115,41848,51632
Madhya Pradesh,VIDISHA,13698,2200,183,105,24,289,16499,35175,21525,54177,29244,3867,1335,145323,161822
Maharashtra,Ahmednagar,6901,930,2006,336,122,221,10516,36316,35296,88399,47126,2644,1058,210839,221355
Maharashtra,Akola,1448,457,221,62,67,49,2304,8680,7764,22616,7292,749,392,47493,49797
Maharashtra,Amravati,5835,2461,487,110,987,260,10140,23451,24329,47782,21204,1673,1048,119487,129627
Maharashtra,Aurangabad,2524,787,494,141,53,55,4054,18715,13454,38313,16796,2074,1024,90376,94430
Maharashtra,Beed,7696,1407,1791,282,134,150,11460,61946,40682,91651,46541,5044,1116,246980,258440
Maharashtra,Bhandara,7379,820,291,99,81,119,8789,23733,21675,32304,16753,2317,1290,98072,106861
Maharashtra,Buldhana,2871,716,492,191,255,114,4639,25189,20970,56211,23250,2350,1539,129509,134148
Maharashtra,Chandrapur,6161,744,419,126,265,207,7922,13942,10261,19802,10493,986,632,56116,64038
Maharashtra,Dhule,5002,1329,383,207,112,60,7093,17140,16497,41037,13359,2186,347,90566,97659
Maharashtra,Gadchiroli,5111,671,13727,540,6422,322,26793,9964,8050,11815,8247,1101,289,39466,66259
Maharashtra,Gondia,8365,964,8475,684,895,223,19606,16919,15097,26030,11937,2385,553,72921,92527
Maharashtra,Hingoli,2441,323,268,85,141,32,3290,16457,11342,29783,11830,1019,404,70835,74125
Maharashtra,Jalgaon,6171,2198,917,329,144,228,9987,51635,43540,116819,38544,6435,2145,259118,269105
Maharashtra,Jalna,4290,968,1792,126,217,139,7532,17184,11480,31357,12657,1527,336,74541,82073
Maharashtra,Kolhapur,3192,734,2446,286,33,128,6819,79414,101746,314768,56259,7704,2174,562065,568884
Maharashtra,Latur,11987,937,823,60,46,254,14107,62661,36810,100573,38698,3314,1024,243080,257187
Maharashtra,Mumbai,301,550,76,99,70,107,1203,887,907,20999,258,82,52,23185,24388
Maharashtra,Nagpur,4726,1519,326,123,96,227,7017,14176,10448,26245,11401,2104,1091,65465,72482
Maharashtra,Nanded,10154,1174,967,136,137,168,12736,62298,31515,94763,27357,6053,1664,223650,236386
Maharashtra,Nandurbar,3830,936,181,109,75,50,5181,15452,11996,25305,12672,2738,622,68785,73966
Maharashtra,Nashik,5453,1518,31986,758,1308,353,41376,35453,26529,82843,27105,5308,2620,179858,221234
Maharashtra,Osmanabad,5187,1120,1280,546,349,332,8814,42984,28420,79073,23984,4183,988,179632,188446
Maharashtra,Palghar,3291,1862,5299,599,286,195,11532,6256,6348,38976,5319,1291,511,58701,70233
Maharashtra,Parbhani,2789,407,391,33,33,30,3683,24790,12612,40181,15078,1704,447,94812,98495
Maharashtra,Pune,4990,1618,533,305,65,74,7585,48429,44016,149726,40137,6011,2244,290563,298148
Maharashtra,Raigad,2975,453,2530,499,164,98,6719,10897,8536,26824,7588,1208,453,55506,62225
Maharashtra,Ratnagiri,2856,345,2425,493,56,112,6287,6509,5499,14329,6668,1240,580,34825,41112
Maharashtra,Sangli,5213,705,560,207,85,293,7063,98538,87227,234854,58910,5650,1756,486935,493998
Maharashtra,Satara,5121,750,571,182,67,178,6869,62867,54742,142630,51090,6162,2536,320027,326896
Maharashtra,Sindhudurg,4697,587,4639,802,52,179,10956,8325,7214,14949,7795,1706,389,40378,51334
Maharashtra,Solapur,9865,1905,1294,457,221,403,14145,111326,81267,216573,63505,7154,2484,482309,496454
Maharashtra,Thane,3986,1609,1387,801,149,250,8182,12964,11642,44700,10564,2208,2261,84339,92521
Maharashtra,Wardha,2671,1299,191,59,21,95,4336,9588,6544,17146,7736,847,452,42313,46649
Maharashtra,Washim,1134,376,261,68,71,67,1977,8444,8010,24222,10400,548,225,51849,53826
Maharashtra,Yavatmal,5139,1484,838,155,64,52,7732,16276,13976,29865,17735,2201,599,80652,88384
Manipur,Bishnupur,48,6,249,19,10,0,332,190,117,222,55,10,0,594,926
Manipur,Chandel,270,21,284,32,13,196,816,69,305,68,51,119,163,775,1591
Manipur,Churachandpur,1105,220,267,119,81,92,1884,1205,1656,1493,433,515,73,5375,7259
Manipur,Imphal East,86,10,18,8,6,2,130,85,79,102,28,57,0,351,481
Manipur,Imphal West,67,7,8,1,47,10,140,146,55,175,39,11,3,429,569
Manipur,Senapati,1034,351,1211,2847,183,566,6192,1285,1536,1285,1183,594,415,6298,12490
Manipur,Tamenglong,410,96,208,165,15,282,1176,507,520,442,161,192,275,2097,3273
Manipur,Thoubal,42,14,64,21,8,6,155,75,108,81,38,12,23,337,492
Manipur,Ukhrul,3094,764,392,458,66,253,5027,873,1757,561,427,369,135,4122,9149
Meghalaya,East Jaintia Hills,147,66,30,235,19,254,751,60,105,46,56,50,56,373,1124
Meghalaya,East Khasi Hills,192,6,25,193,5,75,496,80,44,74,58,18,9,283,779
Meghalaya,North Garo Hills,5,0,0,8,0,0,13,2,1,2,0,2,0,7,20
Meghalaya,Ri Bhoi,594,86,55,1642,18,517,2912,201,347,451,185,118,45,1347,4259
Meghalaya,South Garo Hills,0,0,0,0,0,0,0,1,2,0,0,0,0,3,3
Meghalaya,South West Garo Hills,80,14,28,308,42,8,480,132,111,166,267,21,10,707,1187
Meghalaya,South West Khasi Hills,202,0,15,182,474,48,921,243,141,254,296,22,43,999,1920
Meghalaya,West Garo Hills,57,14,11,88,183,69,422,122,43,170,126,38,16,515,937
Meghalaya,West Jaintia Hills,190,14,0,433,132,753,1522,36,47,12,53,26,10,184,1706
Meghalaya,West Khasi Hills,383,66,115,436,165,1589,2754,133,180,153,167,136,256,1025,3779
Mizoram,AIZAWL,12,0,0,2,0,0,14,13,23,8,0,0,0,44,58
Mizoram,CHAMPHAI,64,38,56,116,9,5,288,75,117,54,153,39,63,501,789
Mizoram,KOLASIB,74,18,53,46,72,1,264,40,56,60,99,10,1,266,530
Mizoram,LAWNGTLAI,15,2,16,5,0,0,38,6,18,6,26,13,19,88,126
Mizoram,LUNGLEI,0,0,0,0,0,0,0,0,4,2,11,8,0,25,25
Mizoram,MAMIT,2,1,1,0,0,0,4,0,3,2,0,2,0,7,11
Mizoram,SERCHHIP,19,11,11,15,2,0,58,23,15,15,37,18,7,115,173
Mizoram,SIAHA,40,9,45,72,5,0,171,8,127,14,62,2,13,226,397
Nagaland,Dimapur,867,88,583,386,377,280,2581,270,322,227,67,163,105,1154,3735
Nagaland,Kiphire,6,4,0,1,0,0,11,3,5,1,3,0,0,12,23
Nagaland,Kohima,42,13,94,17,0,0,166,36,61,26,24,7,0,154,320
Nagaland,Mokokchung,9,4,6,6,46,0,71,0,2,0,0,0,0,2,73
Nagaland,Mon,646,22,17,26,8,3,722,179,83,34,23,7,2,328,1050
Nagaland,Peren,2297,752,1718,702,140,199,5808,819,952,749,317,234,129,3200,9008
Nagaland,Phek,160,170,77,144,3,37,591,172,153,189,87,91,50,742,1333
Nagaland,Tuensang,11,4,0,4,0,3,22,6,9,0,8,0,1,24,46
Nagaland,Wokha,0,5,21,1,8,0,35,2,6,9,3,2,0,22,57
Nagaland,Zunheboto,3,0,0,0,0,0,3,2,4,0,0,0,0,6,9
Odisha,Anugul,714,159,1438,88,547,81,3027,778,656,978,696,91,95,3294,6321
Odisha,Balangir,1915,227,6450,299,345,181,9417,3135,1962,4300,1657,202,87,11343,20760
Odisha,Baleshwar,189,38,377,17,39,11,671,153,154,199,149,13,3,671,1342
Odisha,Bargarh,557,70,1132,68,34,28,1889,638,551,959,634,133,21,2936,4825
Odisha,Bhadrak,256,33,42,2,0,9,342,816,662,1086,525,54,4,3147,3489
Odisha,Boudh,729,80,1833,172,531,44,3389,784,577,946,797,186,51,3341,6730
Odisha,Cuttack,1371,218,1295,225,343,69,3521,2592,2197,4118,1947,342,110,11306,14827
Odisha,Deogarh,142,2,248,9,518,10,929,126,102,193,163,57,1,642,1571
Odisha,Dhenkanal,1808,222,1329,113,151,33,3656,2252,1975,3380,2075,313,78,10073,13729
Odisha,Gajapati,481,86,1526,126,2,6,2227,761,543,1238,596,86,3,3227,5454
Odisha,Ganjam,5103,951,4756,318,600,109,11837,7298,6160,12796,7306,1115,263,34938,46775
Odisha,Jagatsinghapur,630,253,14,2,0,1,900,1871,1681,4135,1949,218,7,9861,10761
Odisha,Jajapur,409,74,236,35,58,15,827,689,663,912,620,144,40,3068,3895
Odisha,Jharsuguda,127,10,335,1,0,0,473,221,194,372,222,34,8,1051,1524
Odisha,Kalahandi,1921,364,7018,355,1441,169,11268,2459,1611,3057,2556,341,140,10164,21432
Odisha,Kandhamal,11529,973,18335,1713,670,580,33800,3012,2787,3697,4627,654,162,14939,48739
Odisha,Kendrapara,948,186,66,27,72,49,1348,2934,2649,4236,2608,672,114,13213,14561
Odisha,Kendujhar,575,116,1724,306,214,78,3013,719,395,952,428,159,41,2694,5707
Odisha,Khordha,749,156,1848,77,498,108,3436,1148,1045,2165,1291,341,210,6200,9636
Odisha,Koraput,4946,554,26430,1750,722,138,34540,5244,5090,7963,6708,1229,245,26479,61019
Odisha,Malkangiri,686,98,1824,410,81,43,3142,632,586,891,955,156,38,3258,6400
Odisha,Mayurbhanj,795,157,3547,176,297,185,5157,741,767,693,933,155,123,3412,8569
Odisha,Nabarangpur,2811,344,10352,326,377,134,14344,2826,2592,3944,3519,443,214,13538,27882
Odisha,Nayagarh,928,64,5359,73,430,60,6914,1140,1036,1647,1420,147,59,5449,12363
Odisha,Nuapada,1182,614,3407,939,160,409,6711,1386,1286,1731,1429,63,53,5948,12659
Odisha,Puri,1283,197,652,219,76,28,2455,2534,2140,3891,2174,260,70,11069,13524
Odisha,Rayagada,3976,503,15155,763,98,216,20711,6264,5281,8834,5772,965,441,27557,48268
Odisha,Sambalpur,686,115,1591,28,141,64,2625,594,516,1244,738,144,37,3273,5898
Odisha,Sonepur,289,66,878,47,102,6,1388,278,192,429,218,62,3,1182,2570
Odisha,Sundargarh,1310,748,5200,198,1670,81,9207,1639,1221,3031,1653,224,119,7887,17094
Puducherry,Karaikal,25,2,2,0,0,2,31,82,77,188,48,36,0,431,462
Puducherry,Pondicherry,16,0,7,4,0,0,27,107,70,148,77,9,1,412,439
Puducherry,Yanam,11,0,0,0,0,6,17,133,106,357,847,32,2,1477,1494
Punjab,Amritsar,10160,937,771,3509,916,128,16421,45312,50788,120629,31368,2347,698,251142,267563
Punjab,Barnala,7049,212,85,38,53,99,7536,29244,28998,58382,17626,2451,462,137163,144699
Punjab,Bathinda,12722,455,60,82,187,134,13640,53628,49617,88139,26898,2621,159,221062,234702
Punjab,Faridkot,3475,273,43,104,22,48,3965,19517,23877,34284,10675,879,146,89378,93343
Punjab,Fatehgarh Sahib,2544,149,78,97,96,10,2974,22784,23123,49679,13991,632,85,110294,113268
Punjab,Fazilka,6366,455,110,159,73,296,7459,31118,39821,55032,23697,4494,358,154520,161979
Punjab,Firozepur,4838,665,261,470,306,125,6665,31056,37202,67056,25336,2703,628,163981,170646
Punjab,Gurdaspur,6092,545,299,678,384,88,8086,40753,38391,88648,30519,2147,413,200871,208957
Punjab,Hoshiarpur,5569,667,398,354,227,94,7309,30771,31449,72141,23984,2638,790,161773,169082
Punjab,Jalandhar,6592,815,418,882,379,112,9198,32552,27986,90677,25169,1954,340,178678,187876
Punjab,Kapurthala,3353,243,533,629,126,25,4909,20367,18367,46191,12860,263,139,98187,103096
Punjab,Ludhiana,12085,1469,280,346,395,112,14687,60968,62713,176164,51712,4552,826,356935,371622
Punjab,Mansa,15295,451,67,48,50,87,15998,49669,50589,77209,25790,3108,660,207025,223023
Punjab,Moga,6672,360,242,146,391,553,8364,33979,36472,70499,17333,1205,160,159648,168012
Punjab,Muktsar,4335,246,21,31,63,47,4743,22046,30229,43777,13430,1648,237,111367,116110
Punjab,Nawanshahr (Sbs Nagar),1618,81,71,103,131,25,2029,17816,13501,43991,9541,752,31,85632,87661
Punjab,Pathankot,1505,429,63,82,83,11,2173,4522,5042,11640,4780,872,314,27170,29343
Punjab,Patiala,6578,358,278,217,184,266,7881,54810,52452,123989,33207,2602,803,267863,275744
Punjab,Rupnagar,1741,167,27,32,7,162,2136,22188,27186,58032,20126,2874,176,130582,132718
Punjab,S.A.S Nagar,2838,206,20,19,40,9,3132,18445,20611,53647,18593,1500,383,113179,116311
Punjab,Sangrur,15784,690,214,111,111,435,17345,84689,82259,159749,53654,4245,534,385130,402475
Punjab,Tarn Taran,6567,827,719,1909,882,80,10984,38160,47666,103407,29783,5539,2178,226733,237717
Rajasthan,Ajmer,49409,2707,314,153,96,504,53183,114173,95417,179093,61847,16008,1058,467596,520779
Rajasthan,Alwar,63948,1455,263,160,135,1390,67351,280969,245757,395256,128246,21233,5941,1077402,1144753
Rajasthan,Banswara,13595,1661,2633,684,233,213,19019,72970,66221,109797,79240,10404,3594,342226,361245
Rajasthan,Baran,22692,3220,501,196,41,386,27036,56689,43945,81365,48958,6782,1242,238981,266017
Rajasthan,Barmer,9817,1959,261,154,53,116,12360,58899,37867,82185,26239,4291,886,210367,222727
Rajasthan,Bharatpur,53763,1526,327,315,99,1593,57623,188005,143162,271754,76284,19967,3528,702700,760323
Rajasthan,Bhilwara,32998,1206,471,235,121,1908,36939,102558,74151,151586,91654,16621,3763,440333,477272
Rajasthan,Bikaner,13396,1896,186,84,62,326,15950,52013,40630,75433,18907,3901,1417,192301,208251
Rajasthan,Bundi,24315,2319,173,185,66,762,27820,75872,58527,99125,54453,7920,1315,297212,325032
Rajasthan,Chittorgarh,33306,2384,613,326,110,610,37349,108497,82766,150721,75607,14002,4303,435896,473245
Rajasthan,Churu,12416,834,311,110,114,605,14390,71922,56041,108389,17765,7405,1431,262953,277343
Rajasthan,Dausa,16583,704,180,85,36,925,18513,139065,96340,193472,61159,14464,3447,507947,526460
Rajasthan,Dholpur,14180,870,104,84,18,228,15484,88575,71391,139973,46958,8098,931,355926,371410
Rajasthan,Dungarpur,17109,1845,1465,293,122,163,20997,71900,58934,103606,62759,9769,1392,308360,329357
Rajasthan,Ganganagar,11253,795,342,131,96,222,12839,36398,50617,69416,23973,5889,993,187286,200125
Rajasthan,Hanumangarh,15921,520,259,39,124,116,16979,68690,65446,110706,29123,9657,1602,285224,302203
Rajasthan,Jaipur,48019,6155,436,173,166,237,55186,308451,230317,438819,155262,23357,2821,1159027,1214213
Rajasthan,Jaisalmer,266,71,40,41,62,54,534,991,761,1242,766,166,178,4104,4638
Rajasthan,Jalore,21280,2948,518,258,143,262,25409,149688,120895,205596,68341,14001,3896,562417,587826
Rajasthan,Jhalawar,13629,2072,624,296,142,537,17300,94639,53486,116235,50190,9032,3335,326917,344217
Rajasthan,Jhunjhunu,8134,502,189,198,44,163,9230,83654,72104,132551,34304,13053,2214,337880,347110
Rajasthan,Jodhpur,18865,1154,130,132,55,279,20615,80078,57927,112733,39145,5901,1453,297237,317852
Rajasthan,Karauli,27143,1091,613,373,90,138,29448,130081,106395,172801,69146,7871,2880,489174,518622
Rajasthan,Kota,20537,2283,80,108,63,345,23416,45513,34923,75421,48117,11370,1868,217212,240628
Rajasthan,Nagaur,28792,2190,568,401,128,257,32336,145176,95009,197323,61335,12838,1325,513006,545342
Rajasthan,Pali,20761,1971,366,165,72,201,23536,76865,60586,116676,45423,5534,1187,306271,329807
Rajasthan,Pratapgarh,11408,784,3013,132,27,178,15542,44337,29930,64994,43998,6174,1097,190530,206072
Rajasthan,Rajsamand,15218,1130,394,68,30,262,17102,53313,32776,80172,37876,11511,1522,217170,234272
Rajasthan,Sawai Madhopur,18263,978,148,46,15,84,19534,77967,46145,115560,36936,4731,919,282258,301792
Rajasthan,Sikar,23340,734,132,244,74,84,24608,120827,102428,185766,45083,9337,749,464190,488798
Rajasthan,Sirohi,9427,1210,401,309,179,52,11578,45534,40111,68094,35082,9256,1350,199427,211005
Rajasthan,Tonk,31770,1785,982,69,71,100,34777,109392,69456,151228,54347,16739,1513,402675,437452
Rajasthan,Udaipur,22557,2266,1825,740,531,1353,29272,128744,111823,193887,110823,18988,3591,567856,597128
Sikkim,East District,4,3,0,0,0,0,7,11,39,15,7,8,0,80,87
Sikkim,North District,8,1,2,0,0,0,11,5,3,24,5,0,1,38,49
Sikkim,South District,40,5,2,11,1,0,59,15,42,19,5,9,2,92,151
Sikkim,West District,112,29,42,2,1,0,186,171,169,214,112,5,0,671,857
Tamil Nadu,Ariyalur,160,25,15,4,0,4,208,408,324,575,290,19,7,1623,1831
Tamil Nadu,Chennai,285,237,23,3,28,108,684,1157,1445,3387,572,200,344,7105,7789
Tamil Nadu,Coimbatore,777,57,31,21,21,142,1049,428,610,867,139,57,20,2121,3170
Tamil Nadu,Cuddalore,379,130,47,27,45,14,642,1287,1045,2060,801,152,44,5389,6031
Tamil Nadu,Dharmapuri,533,122,57,42,27,48,829,5367,4905,9026,4239,472,245,24254,25083
Tamil Nadu,Dindigul,715,367,232,81,33,17,1445,5728,4221,12695,2339,439,194,25616,27061
Tamil Nadu,Erode,3134,1185,907,459,323,207,6215,18838,16654,32719,8646,3495,849,81201,87416
Tamil Nadu,Kanchipuram,3090,1108,483,395,584,350,6010,8949,7571,13604,4147,1107,552,35930,41940
Tamil Nadu,Kanniyakumari,153,45,25,25,11,3,262,304,256,426,97,44,20,1147,1409
Tamil Nadu,Karur,1262,570,202,150,531,56,2771,6256,5295,9920,2174,348,81,24074,26845
Tamil Nadu,Krishnagiri,422,351,243,201,116,44,1377,2001,1728,3556,963,160,58,8466,9843
Tamil Nadu,Madurai,416,142,46,43,41,47,735,610,622,1429,302,132,43,3138,3873
Tamil Nadu,Nagapattinam,412,200,83,23,17,19,754,1805,1424,2131,762,149,68,6339,7093
Tamil Nadu,Namakkal,2589,119,39,34,41,25,2847,14738,12959,24728,6928,982,146,60481,63328
Tamil Nadu,Perambalur,84,67,20,2,8,0,181,203,203,367,64,2,8,847,1028
Tamil Nadu,Pudukkottai,262,82,78,39,49,58,568,789,605,1032,307,193,28,2954,3522
Tamil Nadu,Ramanathapuram,27,5,1,4,0,0,37,90,111,192,45,13,5,456,493
Tamil Nadu,Salem,952,147,235,73,51,45,1503,11043,9677,19235,5509,1188,256,46908,48411
Tamil Nadu,Sivaganga,67,19,10,9,6,3,114,186,207,279,78,18,3,771,885
Tamil Nadu,Thanjavur,318,156,84,58,54,35,705,705,647,1152,328,143,69,3044,3749
Tamil Nadu,The Nilgiris,242,230,32,11,9,8,532,404,351,1102,95,7,3,1962,2494
Tamil Nadu,Theni,330,25,43,39,9,33,479,201,180,459,83,14,7,944,1423
Tamil Nadu,Thiruvallur,4045,1842,498,350,262,238,7235,10260,9021,18111,4790,1344,478,44004,51239
Tamil Nadu,Thiruvarur,78,23,27,13,11,19,171,275,261,278,159,51,17,1041,1212
Tamil Nadu,Tiruchirappalli,572,218,93,53,47,28,1011,1807,1799,3253,836,65,21,7781,8792
Tamil Nadu,Tirunelveli,900,361,107,96,85,30,1579,3075,2316,5272,1637,524,157,12981,14560
Tamil Nadu,Tiruppur,1190,355,179,159,47,48,1978,6230,5359,9885,2602,797,278,25151,27129
Tamil Nadu,Tiruvannamalai,346,82,153,37,22,19,659,1219,865,1921,355,61,34,4455,5114
Tamil Nadu,Tuticorin,308,128,27,98,12,10,583,1022,740,1850,431,94,40,4177,4760
Tamil Nadu,Vellore,967,434,511,368,317,235,2832,3958,2937,4437,1349,344,273,13298,16130
Tamil Nadu,Villupuram,513,234,148,58,133,7,1093,1898,1739,3198,740,217,57,7849,8942
Tamil Nadu,Virudhunagar,391,243,18,8,17,2,679,1288,1249,2157,755,59,13,5521,6200
Telangana,Adilabad,2294,890,477,312,93,56,4122,11135,8510,14677,7045,2867,293,44527,48649
Telangana,BHADRADRI KOTHAGUDEM,11909,3170,2207,1198,656,493,19633,36236,32435,53732,19148,7724,3376,152651,172284
Telangana,Hyderabad,1002,463,61,28,35,53,1642,3662,2098,13908,1176,427,414,21685,23327
Telangana,JANGOAN,7090,637,1151,470,267,322,9937,31638,19926,42738,15892,6133,3392,119719,129656
Telangana,JAYASHANKAR BHUPALAP,4266,1103,1324,847,975,391,8906,29995,22504,38829,13978,7229,2449,114984,123890
Telangana,JOGULAMBA GADWAL,1177,187,292,81,58,195,1990,12688,11078,20093,6861,3808,1722,56250,58240
Telangana,Jagitial,5192,522,528,183,202,142,6769,30875,25299,39818,14681,5998,808,117479,124248
Telangana,KAMAREDDY,5744,1025,466,169,111,88,7603,43780,39438,58710,20063,7806,3668,173465,181068
Telangana,KUMURAM BHEEM ASIFAB,2637,1156,763,678,371,220,5825,11122,10201,15174,4227,2526,370,43620,49445
Telangana,Karimnagar,4731,615,655,509,221,211,6942,22191,16542,34068,9247,4685,1669,88402,95344
Telangana,Khammam,21276,932,1277,311,142,319,24257,91408,62316,129800,40308,17435,9573,350840,375097
Telangana,MAHABUBABAD,5527,903,3451,450,790,266,11387,32728,20431,43016,14166,6313,1587,118241,129628
Telangana,MANCHERIAL,4968,1598,691,258,220,170,7905,25685,24490,35457,7344,3178,1739,97893,105798
Telangana,MEDCHAL MALKAJGIRI,5577,890,107,80,62,133,6849,11495,6884,24987,7321,1797,562,53046,59895
Telangana,Mahbubnagar,6256,1459,1446,546,409,436,10552,34314,25996,53709,14983,6828,3255,139085,149637
Telangana,Medak,8844,2359,2338,1303,614,555,16013,42917,32821,65191,21347,8431,2785,173492,189505
Telangana,NAGARKURNOOL,4328,724,340,171,116,52,5731,28839,17183,41329,12172,5114,1387,106024,111755
Telangana,Nalgonda,16651,1912,1990,1009,520,254,22336,72506,55882,99022,42223,14018,3148,286799,309135
Telangana,Nirmal,5024,1127,1590,614,231,410,8996,28103,24653,38926,12757,5345,2413,112197,121193
Telangana,Nizamabad,5169,1164,926,546,225,141,8171,51984,46008,64603,22017,11214,2901,198727,206898
Telangana,PEDDAPALLI,2852,323,496,194,77,19,3961,22610,18364,33755,7717,3366,860,86672,90633
Telangana,RAJANNA SIRCILLA,3642,456,412,229,80,65,4884,16944,12251,27582,8295,2983,483,68538,73422
Telangana,Rangareddi,12008,2225,1296,497,288,345,16659,36236,20016,72104,16208,4233,1562,150359,167018
Telangana,SANGAREDDY,8828,1340,1037,648,378,966,13197,35294,24941,58465,20370,9703,3303,152076,165273
Telangana,SIDDIPET,6406,1693,1948,941,885,1018,12891,44794,27444,64538,21404,5302,1539,165021,177912
Telangana,SURYAPET,13869,1486,1416,747,299,506,18323,72586,50833,98636,28693,15518,5170,271436,289759
Telangana,VIKARABAD,5367,618,669,1005,71,19,7749,19188,9573,28356,10123,4767,645,72652,80401
Telangana,WANAPARTHY,4651,949,786,167,96,253,6902,15810,10157,26829,7971,3747,1115,65629,72531
Telangana,WARANGAL URBAN,3919,380,478,512,64,75,5428,16775,10241,25987,4547,2760,1403,61713,67141
Telangana,Warangal Rural,4802,679,1165,243,400,73,7362,29918,17886,42692,15941,4399,1278,112114,119476
Telangana,YADADRI BHUVANAGIRI,11441,2780,3276,1614,1247,926,21284,34612,22028,48830,19004,10153,2137,136764,158048
Tripura,Dhalai,206,54,44,62,0,0,366,130,209,160,78,14,1,592,958
Tripura,Gomati,79,38,33,20,0,14,184,104,112,123,114,20,11,484,668
Tripura,Khowai,40,4,2,8,0,0,54,6,13,7,6,1,0,33,87
Tripura,North Tripura,147,62,70,1,9,3,292,241,251,227,91,29,5,844,1136
Tripura,Sepahijala,56,24,44,25,10,8,167,19,17,13,15,2,0,66,233
Tripura,South Tripura,26,17,8,3,6,0,60,24,29,37,20,8,0,118,178
Tripura,Unakoti,159,12,320,6,4,8,509,992,526,1032,451,88,10,3099,3608
Tripura,West Tripura,34,15,42,3,1,1,96,24,36,30,58,19,0,167,263
Uttar Pradesh,Agra,12929,7066,7086,3773,3096,2536,36486,265945,228052,415928,68756,34492,17139,1030312,1066798
Uttar Pradesh,Aligarh,65865,2233,6456,2011,8774,1585,86924,222824,175991,353282,82836,14278,6363,855574,942498
Uttar Pradesh,Allahabad,24698,2650,2475,784,2076,1624,34307,187655,183580,256514,102901,26685,25416,782751,817058
Uttar Pradesh,Ambedkar Nagar,13475,1411,1142,582,201,1245,18056,86481,101009,85163,41720,5226,5628,325227,343283
Uttar Pradesh,Amethi,16656,1150,641,888,558,2096,21989,79500,75652,114151,38160,5755,7457,320675,342664
Uttar Pradesh,Amroha,47273,773,18008,2283,6531,884,75752,106024,103005,176925,40957,7802,4082,438795,514547
Uttar Pradesh,Auraiya,14858,933,744,365,287,159,17346,98473,83145,130960,37533,7538,1903,359552,376898
Uttar Pradesh,Azamgarh,13737,528,303,167,76,343,15154,118297,120476,150245,58596,7956,6839,462409,477563
Uttar Pradesh,Baghpat,19393,466,8757,2971,3386,205,35178,78215,47625,125317,27144,2342,994,281637,316815
Uttar Pradesh,Bahraich,25171,2072,12655,2203,927,1050,44078,100681,84594,120066,56879,10981,6986,380187,424265
Uttar Pradesh,Ballia,4167,214,188,72,34,411,5086,58336,69702,83656,25372,5008,2626,244700,249786
Uttar Pradesh,Balrampur,9983,971,2988,1156,847,1468,17413,52392,57054,58609,27691,7438,5706,208890,226303
Uttar Pradesh,Banda,28492,3634,2851,1382,1130,1942,39431,100937,82558,136672,48330,10980,4860,384337,423768
Uttar Pradesh,Barabanki,29456,3115,933,261,1113,1506,36384,109608,122928,155034,72451,8800,3625,472446,508830
Uttar Pradesh,Bareilly,57433,3084,11710,2384,2947,2195,79753,149438,142566,240775,61144,16875,17058,627856,707609
Uttar Pradesh,Basti,15538,5188,4109,4043,4104,3313,36295,80878,108443,82772,26837,5607,2967,307504,343799
Uttar Pradesh,Bijnor,48598,2295,20263,2490,8470,3090,85206,148541,103572,214187,53917,12365,4617,537199,622405
Uttar Pradesh,Budaun,67959,9609,12237,5670,4450,3903,103828,241084,240369,364884,118953,21896,16156,1003342,1107170
Uttar Pradesh,Bulandshahr,57750,4540,19237,4234,20710,1240,107711,200946,178016,391538,65911,21237,6668,864316,972027
Uttar Pradesh,Chandauli,5516,217,108,62,30,73,6006,88330,78457,104443,35635,4633,5613,317111,323117
Uttar Pradesh,Chitrakoot,14979,1203,598,331,72,151,17334,64404,45209,84656,32745,4831,2509,234354,251688
Uttar Pradesh,Deoria,3547,521,144,265,144,1770,6391,52802,52721,58002,14079,2869,4030,184503,190894
Uttar Pradesh,Etah,16105,586,627,255,247,1189,19009,152542,124641,224091,53875,14219,5173,574541,593550
Uttar Pradesh,Etawah,20386,691,808,357,384,233,22859,86631,90294,145526,25419,6839,6251,360960,383819
Uttar Pradesh,Faizabad,15011,601,253,72,74,430,16441,82317,103653,96843,41854,4346,2707,331720,348161
Uttar Pradesh,Farrukhabad,15595,1693,1801,328,646,160,20223,109760,102714,152783,42600,11585,4036,423478,443701
Uttar Pradesh,Fatehpur,42597,2178,3214,1245,749,2978,52961,149632,129937,224579,72285,13013,5096,594542,647503
Uttar Pradesh,Firozabad,18886,973,1352,474,79,918,22682,158208,150150,238713,54610,16495,4700,622876,645558
Uttar Pradesh,Gautam Buddha Nagar,18076,1498,2875,772,2124,1169,26514,54461,38457,120329,18089,5288,1844,238468,264982
Uttar Pradesh,Ghaziabad,12791,1257,5460,405,3437,242,23592,44447,24905,97525,20445,1767,1039,190128,213720
Uttar Pradesh,Ghazipur,8705,347,300,223,130,488,10193,120504,138331,146634,73412,11664,5227,495772,505965
Uttar Pradesh,Gonda,14059,927,674,161,44,546,16411,98661,101586,144352,59827,13265,4069,421760,438171
Uttar Pradesh,Gorakhpur,8726,616,292,159,103,2317,12213,60887,64126,77085,32433,3450,2996,240977,253190
Uttar Pradesh,Hamirpur,10599,653,605,46,74,605,12582,70102,39298,89715,21470,4291,1052,225928,238510
Uttar Pradesh,Hapur,23021,189,15549,1241,2737,812,43549,49641,36034,96904,17949,1845,864,203237,246786
Uttar Pradesh,Hardoi,44056,3953,8280,1775,2261,3435,63760,184337,169992,299664,84780,19738,12479,770990,834750
Uttar Pradesh,Hathras,11908,623,667,509,737,1254,15698,102697,77528,170467,34863,8718,7807,402080,417778
Uttar Pradesh,Jalaun,13935,844,529,274,67,145,15794,99408,65424,138411,27070,8606,2984,341903,357697
Uttar Pradesh,Jaunpur,21920,1477,807,461,250,584,25499,134170,120280,185962,93247,13989,11307,558955,584454
Uttar Pradesh,Jhansi,5619,976,431,129,134,250,7539,83735,52659,118627,32588,9188,2215,299012,306551
Uttar Pradesh,Kannauj,14724,3564,6166,2338,2304,3121,32217,97755,99366,135742,30766,24481,10627,398737,430954
Uttar Pradesh,Kanpur Dehat,29701,2931,1637,978,314,1185,36746,153997,133451,230786,37580,7038,3115,565967,602713
Uttar Pradesh,Kanpur Nagar,19660,1591,872,501,205,1260,24089,121672,95718,199045,44860,5260,3401,469956,494045
Uttar Pradesh,Kasganj,19118,1109,2040,563,684,1115,24629,129646,135893,181086,44660,7064,4731,503080,527709
Uttar Pradesh,Kaushambi,23257,3362,2778,1346,427,464,31634,96580,79354,113370,33814,5865,3786,332769,364403
Uttar Pradesh,Kheri,56027,4939,28697,5082,5196,2346,102287,172333,199097,223643,92142,30888,15968,734071,836358
Uttar Pradesh,Kushi Nagar,6233,251,194,96,146,332,7252,47329,38237,51847,22056,1463,2010,162942,170194
Uttar Pradesh,Lalitpur,17639,3216,1054,859,84,257,23109,73935,57860,87128,42633,4219,2859,268634,291743
Uttar Pradesh,Lucknow,15795,1860,949,333,161,469,19567,64076,52220,110348,30485,6773,3181,267083,286650
Uttar Pradesh,Maharajganj,6677,677,124,214,85,558,8335,46883,39019,55633,25913,3414,1433,172295,180630
Uttar Pradesh,Mahoba,6382,1179,252,39,103,101,8056,35784,23252,46806,18935,2350,2684,129811,137867
Uttar Pradesh,Mainpuri,28112,3824,4661,915,771,2013,40296,153688,121941,202822,50719,10533,12913,552616,592912
Uttar Pradesh,Mathura,28204,1844,1943,861,1527,1007,35386,147445,102710,232152,47113,8646,3104,541170,576556
Uttar Pradesh,Mau,5742,223,91,40,43,158,6297,50992,43736,58345,26355,3464,3522,186414,192711
Uttar Pradesh,Meerut,39479,1869,28963,2449,6896,1046,80702,106484,69084,216199,31145,8441,3649,435002,515704
Uttar Pradesh,Mirzapur,7795,2360,2224,362,91,137,12969,64139,57333,100273,42604,7009,3255,274613,287582
Uttar Pradesh,Moradabad,40328,2892,12884,2812,1902,777,61595,90209,72899,145068,29951,6971,2027,347125,408720
Uttar Pradesh,Muzaffarnagar,41097,1336,25755,2835,6931,1211,79165,95384,83082,164243,30235,4448,3190,380582,459747
Uttar Pradesh,Pilibhit,20592,465,4629,577,493,1445,28201,45879,54180,66759,19316,3827,2216,192177,220378
Uttar Pradesh,Pratapgarh,19709,2318,1649,1311,841,983,26811,152789,144964,174572,62602,20150,14187,569264,596075
Uttar Pradesh,Rae Bareli,37298,1786,2189,777,1151,744,43945,100862,95001,141816,62936,13844,5288,419747,463692
Uttar Pradesh,Rampur,21569,1301,4408,1341,1490,2871,32980,76683,71978,131228,22757,5110,12844,320600,353580
Uttar Pradesh,Saharanpur,26329,604,10290,1287,2684,444,41638,122314,88673,170506,43781,2880,2181,430335,471973
Uttar Pradesh,Sambhal,51195,2278,4094,1525,1543,854,61489,161285,155147,246491,64968,16605,5008,649504,710993
Uttar Pradesh,Sant Kabeer Nagar,6032,1003,1335,1310,88,230,9998,31450,42363,39223,17702,2307,1648,134693,144691
Uttar Pradesh,Sant Ravidas Nagar,4355,415,261,133,45,123,5332,38381,37406,48264,19181,3512,4527,151271,156603
Uttar Pradesh,Shahjahanpur,29829,1864,7701,1071,646,939,42050,142051,134425,196607,73502,9970,6782,563337,605387
Uttar Pradesh,Shamli,18912,172,7244,961,3055,299,30643,63149,44526,88421,23428,2135,984,222643,253286
Uttar Pradesh,Shravasti,4848,710,4609,281,186,366,11000,41461,30909,62292,18122,7270,3325,163379,174379
Uttar Pradesh,Siddharth Nagar,5405,405,253,134,147,452,6796,47198,57959,52090,10563,3975,4371,176156,182952
Uttar Pradesh,Sitapur,34699,3206,7598,1836,1515,1859,50713,177941,137543,219124,75462,10652,11938,632660,683373
Uttar Pradesh,Sonbhadra,9082,1012,1349,241,48,137,11869,32227,28578,45317,24840,3684,2117,136763,148632
Uttar Pradesh,Sultanpur,12512,1274,581,398,360,959,16084,73158,78111,99994,37144,6529,7765,302701,318785
Uttar Pradesh,Unnao,52381,3405,7260,1616,1137,3176,68975,147060,133191,220914,68627,12800,4925,587517,656492
Uttar Pradesh,Varanasi,3807,529,489,168,39,117,5149,60245,53202,89086,29116,3888,2999,238536,243685
Uttarakhand,Almora,2861,368,150,29,1,55,3464,14641,11526,35653,10463,1507,190,73980,77444
Uttarakhand,Bageshwar,289,185,49,10,1,20,554,3915,4413,18018,4163,338,31,30878,31432
Uttarakhand,Champawat,598,173,53,3,4,9,840,4173,3157,8153,1884,357,35,17759,18599
Uttarakhand,Dehradun,2696,312,242,115,374,92,3831,10339,7868,22708,6017,1081,341,48354,52185
Uttarakhand,Haridwar,21472,627,6595,1196,1951,727,32568,42307,33193,82555,18468,4376,1013,181912,214480
Uttarakhand,Nainital,5542,592,170,142,88,170,6704,15975,11898,30923,9684,2108,467,71055,77759
Uttarakhand,Pauri Garhwal,1006,328,135,38,5,11,1523,6897,4396,12251,4175,511,323,28553,30076
Uttarakhand,Pithoragarh,986,268,41,16,0,2,1313,6317,4590,18658,5105,964,109,35743,37056
Uttarakhand,Rudraprayag,182,203,39,5,0,1,430,3106,5518,17358,3516,1148,39,30685,31115
Uttarakhand,Tehri Garhwal,1871,577,127,10,2,12,2599,12939,8725,44289,9265,1227,350,76795,79394
Uttarakhand,Udham Singh Nagar,13069,776,933,400,1093,844,17115,29390,33325,51928,15934,3686,1533,135796,152911
Uttarakhand,Uttarkashi,475,234,16,5,0,2,732,4870,4284,11264,4025,467,303,25213,25945
Uttarakhand,chamoli,347,253,50,14,5,16,685,4045,6010,21808,4690,454,230,37237,37922
West Bengal,24 Paraganas North,579,523,401,102,37,134,1776,1477,1907,27587,1045,368,283,32667,34443
West Bengal,24 Paraganas South,595,245,348,156,105,113,1562,929,893,7524,479,173,149,10147,11709
West Bengal,Alipurduar,171,89,98,66,57,84,565,465,401,371,291,100,16,1644,2209
West Bengal,Bankura,5808,945,30658,1550,3358,854,43173,5100,4125,7643,3257,860,269,21254,64427
West Bengal,Bardhaman,5456,701,13484,684,1300,419,22044,9018,5523,18230,2958,901,268,36898,58942
West Bengal,Birbhum,12904,5364,26434,5563,5076,584,55925,7865,8771,11127,6147,4779,324,39013,94938
West Bengal,Coochbehar,479,194,968,214,303,580,2738,708,904,1080,422,257,288,3659,6397
West Bengal,Darjeeling,741,564,682,671,826,1001,4485,527,495,809,309,219,148,2507,6992
West Bengal,Dinajpur Dakshin,215,31,1235,70,41,25,1617,76,78,80,53,9,7,303,1920
West Bengal,Dinajpur Uttar,803,275,2523,357,308,54,4320,2917,1696,2151,1062,158,80,8064,12384
West Bengal,Hooghly,1692,719,4515,129,190,277,7522,4724,4089,16871,1268,443,312,27707,35229
West Bengal,Howrah,82,27,26,15,4,5,159,385,475,4285,363,36,21,5565,5724
West Bengal,Jalpaiguri,671,226,557,163,62,68,1747,879,788,1258,589,74,46,3634,5381
West Bengal,Jhargram,2334,621,15881,393,2062,344,21635,1833,1935,2386,895,206,125,7380,29015
West Bengal,KALIMPONG,17,1,20,0,0,2,40,10,18,34,6,21,0,89,129
West Bengal,Kolkata,20,0,0,0,0,0,20,52,40,313,24,9,1,439,459
West Bengal,Maldah,4265,1045,9117,1131,1031,556,17145,5136,5386,6324,2849,880,719,21294,38439
West Bengal,Medinipur East,25,12,1,3,1,4,46,69,52,64,22,8,2,217,263
West Bengal,Medinipur West,4243,693,13228,1526,2494,240,22424,3225,3623,5801,2155,333,88,15225,37649
West Bengal,Murshidabad,10137,2186,12425,1656,1568,822,28794,9558,9762,11159,4237,1266,2007,37989,66783
West Bengal,Nadia,2326,558,5139,472,305,150,8950,2126,1797,3058,875,274,77,8207,17157
West Bengal,PASCHIM BARDHAMAN,1975,312,1691,285,921,155,5339,3707,2632,8178,1816,898,112,17343,22682
West Bengal,Purulia,4231,1197,53132,1495,3063,663,63781,3208,2587,5248,1761,609,456,13869,77650