state_name,district_name,breed_type_name,upto_one_ and_half_years,used_for_ breeding_only,used_for_ agriculture_only,agriculture_ and_breeding,bullock_car t_farm_operation,others_male,total_male,under_one_ year,one_to_two_and_half_y ears,in_milk,dry,not_calved_ once,others_female,total_femal e,total
Andaman And Nicobar Island,Nicobars,Exotic,0,0,0,0,0,0,0,14,10,15,1,0,0,40,40
Andaman And Nicobar Island,Nicobars,Indigenous(Desi),169,109,45,75,10,58,466,337,362,458,255,64,22,1498,1964
Andaman And Nicobar Island,North And Middle Andaman,Exotic,562,22,35,39,2,12,672,1434,843,2130,1219,206,67,5899,6571
Andaman And Nicobar Island,North And Middle Andaman,Indigenous(Desi),983,177,2033,1104,19,55,4371,1419,806,1508,905,81,57,4776,9147
Andaman And Nicobar Island,South Andamans,Exotic,824,228,20,57,15,22,1166,1440,1571,3057,1448,192,34,7742,8908
Andaman And Nicobar Island,South Andamans,Indigenous(Desi),1368,135,429,236,121,13,2302,1947,1518,2214,1550,251,26,7506,9808
Andhra Pradesh,Anantapur,Exotic,4917,1920,4350,1083,1908,664,14842,47328,37304,89968,25051,7725,3677,211053,225895
Andhra Pradesh,Anantapur,Indigenous(Desi),18088,4061,47627,8408,18173,1833,98190,40434,33106,63745,24142,7570,4020,173017,271207
Andhra Pradesh,Chittoor,Exotic,32614,1994,4241,1224,767,610,41450,178310,141340,352055,83265,22438,10994,788402,829852
Andhra Pradesh,Chittoor,Indigenous(Desi),9835,1281,12993,1333,1288,358,27088,20586,17725,36869,13186,3549,1171,93086,120174
Andhra Pradesh,East Godavari,Exotic,2806,427,588,434,201,56,4512,20814,15840,34927,8212,3929,1793,85515,90027
Andhra Pradesh,East Godavari,Indigenous(Desi),24402,10501,37795,14690,10226,2599,100213,44784,43547,68600,31557,11775,5518,205781,305994
Andhra Pradesh,Guntur,Exotic,951,394,1025,295,202,34,2901,2179,1978,3677,1159,781,457,10231,13132
Andhra Pradesh,Guntur,Indigenous(Desi),6453,1249,29605,1207,1494,481,40489,9474,8139,15216,5661,2497,1319,42306,82795
Andhra Pradesh,Krishna,Exotic,703,176,264,153,205,83,1584,1836,1525,3819,891,330,282,8683,10267
Andhra Pradesh,Krishna,Indigenous(Desi),5106,911,7837,954,2683,569,18060,11981,10703,18038,6464,2137,1196,50519,68579
Andhra Pradesh,Kurnool,Exotic,994,565,1447,360,1191,242,4799,2461,2711,4330,1514,857,531,12404,17203
Andhra Pradesh,Kurnool,Indigenous(Desi),23830,4484,115265,7050,28879,1391,180899,35665,32470,51348,28114,8295,2128,158020,338919
Andhra Pradesh,Prakasam,Exotic,412,96,319,122,173,52,1174,2197,2117,3769,771,219,137,9210,10384
Andhra Pradesh,Prakasam,Indigenous(Desi),4137,789,18157,1474,3168,260,27985,6599,6842,10353,4218,1315,613,29940,57925
Andhra Pradesh,Spsr Nellore,Exotic,1055,186,254,103,114,87,1799,3840,2924,5854,1904,579,308,15409,17208
Andhra Pradesh,Spsr Nellore,Indigenous(Desi),6974,1000,4648,1062,1885,488,16057,18278,16801,26302,8766,3185,1261,74593,90650
Andhra Pradesh,Srikakulam,Exotic,27697,2449,18221,2668,9834,963,61832,99320,55682,140540,30555,17612,5526,349235,411067
Andhra Pradesh,Srikakulam,Indigenous(Desi),10973,1320,17892,3816,8099,816,42916,31687,19692,43175,13532,6959,2915,117960,160876
Andhra Pradesh,Visakhapatanam,Exotic,7089,852,2383,620,615,255,11814,47174,30415,72233,15304,7773,2910,175809,187623
Andhra Pradesh,Visakhapatanam,Indigenous(Desi),54034,22509,153027,25132,6548,3717,264967,47007,46641,65636,21008,10853,5008,196153,461120
Andhra Pradesh,Vizianagaram,Exotic,15223,2254,8445,1881,2623,1584,32010,75945,59040,112281,37460,13310,7281,305317,337327
Andhra Pradesh,Vizianagaram,Indigenous(Desi),14449,1896,24008,4488,6657,809,52307,26374,23725,30815,12510,5355,2576,101355,153662
Andhra Pradesh,West Godavari,Exotic,2900,570,601,376,478,375,5300,12287,8849,18172,4396,1891,1076,46671,51971
Andhra Pradesh,West Godavari,Indigenous(Desi),9509,2037,10068,3703,5331,599,31247,27510,22873,44343,12528,6472,4158,117884,149131
Andhra Pradesh,Y.S.R.,Exotic,1566,589,773,461,425,338,4152,13674,13745,22254,4404,1317,727,56121,60273
Andhra Pradesh,Y.S.R.,Indigenous(Desi),5574,1540,9317,1842,3108,399,21780,13636,12270,18204,7896,2045,995,55046,76826
Arunachal Pradesh,Anjaw,Indigenous(Desi),272,24,52,10,0,111,469,163,255,204,132,41,96,891,1360
Arunachal Pradesh,Changlang,Exotic,18,6,4,9,0,1,38,10,12,6,4,2,0,34,72
Arunachal Pradesh,Changlang,Indigenous(Desi),3620,891,8545,355,153,86,13650,3613,2333,3695,1909,1204,93,12847,26497
Arunachal Pradesh,Dibang Valley,Exotic,6,4,5,6,0,0,21,12,8,31,9,1,8,69,90
Arunachal Pradesh,Dibang Valley,Indigenous(Desi),13,11,10,15,0,6,55,9,3,32,18,3,1,66,121
Arunachal Pradesh,East Kameng,Exotic,0,0,0,0,0,0,0,7,4,39,0,0,14,64,64
Arunachal Pradesh,East Kameng,Indigenous(Desi),5195,673,2589,627,155,1125,10364,4526,5086,1742,1326,855,786,14321,24685
Arunachal Pradesh,East Siang,Exotic,26,15,17,4,0,27,89,41,24,118,19,10,9,221,310
Arunachal Pradesh,East Siang,Indigenous(Desi),3560,665,11162,685,166,1305,17543,3784,3540,4502,2375,2173,1719,18093,35636
Arunachal Pradesh,Kra Daadi,Indigenous(Desi),2059,141,24,13,17,33,2287,1750,2044,1654,1361,374,33,7216,9503
Arunachal Pradesh,Kurung Kumey,Indigenous(Desi),327,330,4,5,3,2,671,131,424,125,68,210,8,966,1637
Arunachal Pradesh,Lohit,Exotic,464,174,184,3,0,10,835,518,466,907,349,118,48,2406,3241
Arunachal Pradesh,Lohit,Indigenous(Desi),9146,1838,15470,1273,58,511,28296,8405,6359,10759,6048,2879,461,34911,63207
Arunachal Pradesh,Longding,Indigenous(Desi),584,220,199,10,46,51,1110,463,314,705,160,47,3,1692,2802
Arunachal Pradesh,Lower Dibang Valley,Exotic,11,2,47,1,0,3,64,2,4,3,5,13,0,27,91
Arunachal Pradesh,Lower Dibang Valley,Indigenous(Desi),1480,316,3404,377,268,255,6100,1544,1556,2046,1357,1572,258,8333,14433
Arunachal Pradesh,Lower Subansiri,Indigenous(Desi),6183,2930,1705,1439,899,1886,15042,5962,8582,3592,2383,1286,1328,23133,38175
Arunachal Pradesh,NAMSAI,Exotic,21,18,0,0,0,8,47,41,43,137,44,37,19,321,368
Arunachal Pradesh,NAMSAI,Indigenous(Desi),1022,240,2407,43,4,24,3740,1114,690,1169,1084,141,38,4236,7976
Arunachal Pradesh,Papum Pare,Exotic,121,83,10,20,1,22,257,159,206,453,125,86,39,1068,1325
Arunachal Pradesh,Papum Pare,Indigenous(Desi),4278,1426,4773,1572,111,335,12495,4119,4754,3374,1471,1034,318,15070,27565
Arunachal Pradesh,SIANG,Exotic,0,1,0,0,0,0,1,0,0,0,0,0,0,0,1
Arunachal Pradesh,SIANG,Indigenous(Desi),1336,383,661,634,34,1093,4141,1137,1368,1071,1535,1076,413,6600,10741
Arunachal Pradesh,Tawang,Exotic,100,34,1,4,2,6,147,90,173,292,32,16,1,604,751
Arunachal Pradesh,Tawang,Indigenous(Desi),1920,1125,531,549,55,233,4413,2409,2620,3769,1818,1337,245,12198,16611
Arunachal Pradesh,Tirap,Exotic,0,4,0,0,0,10,14,0,0,0,0,0,0,0,14
Arunachal Pradesh,Tirap,Indigenous(Desi),484,212,135,93,18,149,1091,207,434,186,87,79,45,1038,2129
Arunachal Pradesh,Upper Siang,Exotic,1,16,0,9,0,9,35,12,21,34,13,16,3,99,134
Arunachal Pradesh,Upper Siang,Indigenous(Desi),1405,411,886,243,34,258,3237,993,1012,871,420,422,131,3849,7086
Arunachal Pradesh,Upper Subansiri,Exotic,4,10,0,0,0,3,17,18,17,104,18,15,27,199,216
Arunachal Pradesh,Upper Subansiri,Indigenous(Desi),2560,755,260,15,28,1424,5042,2341,2532,1956,1434,1264,1028,10555,15597
Arunachal Pradesh,West Kameng,Exotic,15,2,0,1,0,0,18,28,80,40,60,25,4,237,255
Arunachal Pradesh,West Kameng,Indigenous(Desi),2131,926,1161,622,35,443,5318,1970,2178,3012,1579,717,186,9642,14960
Arunachal Pradesh,West Siang,Exotic,0,7,0,1,0,0,8,6,8,18,10,5,0,47,55
Arunachal Pradesh,West Siang,Indigenous(Desi),1642,521,1052,330,94,800,4439,1283,2223,1639,997,425,507,7074,11513
Assam,BAKSA,Exotic,1129,169,995,65,43,46,2447,4054,3193,5479,1342,413,70,14551,16998
Assam,BAKSA,Indigenous(Desi),36416,6328,42973,2431,3104,2785,94037,78309,51369,87090,26939,6026,3338,253071,347108
Assam,BONGAIGAON,Exotic,2090,236,210,42,24,24,2626,6904,4977,8183,3989,186,1378,25617,28243
Assam,BONGAIGAON,Indigenous(Desi),27289,5320,24237,2337,1272,4607,65062,47119,35922,54508,20503,3061,2534,163647,228709
Assam,Barpeta,Exotic,5288,585,564,324,147,441,7349,19199,13160,23037,7815,1267,1019,65497,72846
Assam,Barpeta,Indigenous(Desi),45081,11286,16082,5357,3019,3809,84634,92606,81914,96313,38804,7809,7589,325035,409669
Assam,Biswanath,Exotic,773,146,558,108,96,160,1841,2521,1941,3342,900,316,211,9231,11072
Assam,Biswanath,Indigenous(Desi),41852,8686,60926,12355,1246,1651,126716,64478,49815,71914,25140,9338,3791,224476,351192
Assam,Cachar,Exotic,951,193,371,112,20,70,1717,7218,4244,7994,2218,612,682,22968,24685
Assam,Cachar,Indigenous(Desi),21401,3845,33537,8168,1624,2080,70655,77156,57151,78082,34050,8867,4197,259503,330158
Assam,Chirang,Exotic,1513,633,352,29,22,71,2620,2520,1682,2614,634,151,25,7626,10246
Assam,Chirang,Indigenous(Desi),20283,2746,34953,8044,1914,2220,70160,32855,23886,42640,16727,8220,2934,127262,197422
Assam,DARRANG,Exotic,1213,407,700,219,51,63,2653,5102,4561,6135,1905,709,495,18907,21560
Assam,DARRANG,Indigenous(Desi),37974,13404,25736,10076,3584,6070,96844,95966,92736,100917,33787,9706,5910,339022,435866
Assam,DHEMAJI,Exotic,87,32,307,10,12,6,454,215,128,281,78,5,0,707,1161
Assam,DHEMAJI,Indigenous(Desi),61147,25622,169851,16094,6689,8150,287553,65892,42503,82565,32331,11663,3312,238266,525819
Assam,DHUBRI,Exotic,706,150,121,48,62,60,1147,2717,2631,3208,2729,168,43,11496,12643
Assam,DHUBRI,Indigenous(Desi),32639,10381,35881,7684,3593,1831,92009,63275,61157,69048,48018,6253,3654,251405,343414
Assam,Dibrugarh,Exotic,1835,535,722,198,156,266,3712,4021,2933,5748,1539,680,454,15375,19087
Assam,Dibrugarh,Indigenous(Desi),48139,13721,74597,8047,2771,7499,154774,47275,34185,55539,17503,5599,6662,166763,321537
Assam,Dima Hasao,Exotic,2712,1878,1998,126,26,56,6796,361,279,416,226,137,39,1458,8254
Assam,Dima Hasao,Indigenous(Desi),1705,692,958,723,138,321,4537,3114,2390,2699,629,612,341,9785,14322
Assam,Goalpara,Exotic,878,154,106,37,29,37,1241,2480,1469,3324,641,355,33,8302,9543
Assam,Goalpara,Indigenous(Desi),32792,8924,51222,7370,3571,2892,106771,63188,48456,66824,25265,9283,4291,217307,324078
Assam,Golaghat,Exotic,1850,1472,1763,773,623,945,7426,10156,7664,10879,6960,1312,1484,38455,45881
Assam,Golaghat,Indigenous(Desi),37538,6889,40629,4849,3384,3278,96567,121272,117921,131565,55247,21989,21011,469005,565572
Assam,Hailakandi,Exotic,298,192,265,117,134,52,1058,2742,2152,2900,1369,270,96,9529,10587
Assam,Hailakandi,Indigenous(Desi),7918,1569,13549,880,429,1029,25374,28661,20685,29929,12767,3044,1181,96267,121641
Assam,Hojai,Exotic,5651,1506,2088,1642,1169,1053,13109,17989,12629,14228,5552,2643,1873,54914,68023
Assam,Hojai,Indigenous(Desi),18559,4485,16180,3856,1890,3545,48515,53637,41638,46564,21558,10114,8745,182256,230771
Assam,Jorhat,Exotic,1133,308,458,175,152,242,2468,4533,3691,6393,2620,938,267,18442,20910
Assam,Jorhat,Indigenous(Desi),39607,7183,32575,4231,1428,2871,87895,91131,86758,95568,37674,7545,4914,323590,411485
Assam,Kamrup,Exotic,2599,294,392,879,123,334,4621,8511,5804,10480,3022,767,222,28806,33427
Assam,Kamrup,Indigenous(Desi),40868,5113,41076,2949,2105,3147,95258,104865,78998,125624,50782,6477,4506,371252,466510
Assam,Kamrup (M),Exotic,1654,732,256,223,198,207,3270,6398,5979,15075,3612,1494,477,33035,36305
Assam,Kamrup (M),Indigenous(Desi),7695,1920,4485,453,160,171,14884,17322,17665,24401,7242,1645,788,69063,83947
Assam,Karbi Anglong,Exotic,3061,302,4974,575,0,337,9249,5828,1369,12058,2595,321,231,22402,31651
Assam,Karbi Anglong,Indigenous(Desi),23655,3686,47750,5796,635,1917,83439,36745,18085,66507,14223,2894,1512,139966,223405
Assam,Karimganj,Exotic,1750,331,510,105,99,101,2896,5498,4162,7544,1244,515,553,19516,22412
Assam,Karimganj,Indigenous(Desi),22080,4074,27604,5132,1621,1702,62213,54709,41399,62079,22178,8058,6119,194542,256755
Assam,Kokrajhar,Exotic,726,92,75,36,14,1,944,1558,1243,1911,634,89,9,5444,6388
Assam,Kokrajhar,Indigenous(Desi),30274,6455,84752,9850,1308,2272,134911,46595,42718,57540,33913,10415,1111,192292,327203
Assam,Lakhimpur,Exotic,1136,546,968,383,503,58,3594,3391,2650,4396,1262,176,171,12046,15640
Assam,Lakhimpur,Indigenous(Desi),67056,23021,180643,15741,2177,5962,294600,95406,67705,112739,28995,8749,5194,318788,613388
Assam,Majuli,Exotic,26,6,17,5,3,1,58,44,32,49,33,5,2,165,223
Assam,Majuli,Indigenous(Desi),16245,3067,27347,1822,190,1290,49961,22117,16632,23444,8012,1680,1693,73578,123539
Assam,Morigaon,Exotic,2178,1093,356,113,120,133,3993,6395,5340,8021,3086,848,364,24054,28047
Assam,Morigaon,Indigenous(Desi),36888,7673,32366,3063,2176,938,83104,68669,64589,71178,26445,8679,4768,244328,327432
Assam,Nagaon,Exotic,5423,3514,2708,2360,1697,2127,17829,21492,16958,21223,7875,2041,1806,71395,89224
Assam,Nagaon,Indigenous(Desi),41064,10329,46947,6412,2563,3322,110637,111168,103061,125856,57089,15583,13833,426590,537227
Assam,Nalbari,Exotic,2359,149,248,103,81,144,3084,8612,5263,10622,2717,927,235,28376,31460
Assam,Nalbari,Indigenous(Desi),17175,1209,10965,1343,2318,1333,34343,51447,35370,67641,21671,6127,2152,184408,218751
Assam,Sibsagar,Exotic,561,95,115,30,10,46,857,2057,1377,2476,602,254,97,6863,7720
Assam,Sibsagar,Indigenous(Desi),26750,3781,30139,2745,887,2919,67221,54952,41017,58235,20589,6632,9665,191090,258311
Assam,Sonitpur,Exotic,2296,1098,1308,996,820,612,7130,8970,6377,9991,3061,1244,812,30455,37585
Assam,Sonitpur,Indigenous(Desi),46218,14711,67635,6667,4512,4838,144581,91534,73315,96286,43508,15042,12133,331818,476399
Assam,Soraideu,Exotic,166,4,69,6,2,9,256,476,269,668,252,21,6,1692,1948
Assam,Soraideu,Indigenous(Desi),11811,917,21443,815,148,1096,36230,14540,9375,16331,7454,2313,418,50431,86661
Assam,South Salmara,Exotic,483,63,24,23,18,18,629,997,626,1233,300,57,26,3239,3868
Assam,South Salmara,Indigenous(Desi),16259,4141,18658,2615,1162,1368,44203,24066,24947,29315,10866,2778,1875,93847,138050
Assam,Tinsukia,Exotic,908,408,501,132,46,77,2072,5096,5231,7458,2620,1106,1525,23036,25108
Assam,Tinsukia,Indigenous(Desi),39442,19071,78849,9625,1950,5566,154503,53035,46216,61213,28123,8674,5658,202919,357422
Assam,Udalguri,Exotic,325,115,179,76,37,77,809,2119,1825,2801,958,284,286,8273,9082
Assam,Udalguri,Indigenous(Desi),33226,14848,56344,14332,6817,11457,137024,62427,52777,68628,26048,13485,13661,237026,374050
Assam,West Karbi Anglong,Exotic,595,48,300,72,12,68,1095,1844,1340,2004,674,124,41,6027,7122
Assam,West Karbi Anglong,Indigenous(Desi),11105,2020,29244,2080,1571,2064,48084,18037,11955,22290,8243,3202,666,64393,112477
Bihar,Araria,Exotic,1523,1016,1050,836,747,1135,6307,6053,5667,7151,3506,1536,1149,25062,31369
Bihar,Araria,Indigenous(Desi),34398,11338,17852,7349,4983,4191,80111,178557,177271,186689,65699,17059,10210,635485,715596
Bihar,Arwal,Exotic,274,10,17,5,0,0,306,1534,2100,2451,787,86,25,6983,7289
Bihar,Arwal,Indigenous(Desi),1146,184,248,56,12,11,1657,20120,8900,23363,7433,1109,515,61440,63097
Bihar,Aurangabad,Exotic,1351,46,32,10,9,14,1462,6852,4504,10214,3813,343,47,25773,27235
Bihar,Aurangabad,Indigenous(Desi),22131,653,8926,392,118,242,32462,103549,84963,134230,75162,7419,1088,406411,438873
Bihar,Banka,Exotic,2413,313,604,189,42,103,3664,19843,15830,22614,8105,1244,246,67882,71546
Bihar,Banka,Indigenous(Desi),50387,6315,58833,6852,2032,1847,126266,141763,115128,168158,74183,18534,3558,521324,647590
Bihar,Begusarai,Exotic,5292,528,916,609,81,71,7497,117611,82834,186006,42561,4428,1225,434665,442162
Bihar,Begusarai,Indigenous(Desi),217,27,146,15,28,5,438,3554,3557,5251,1605,262,146,14375,14813
Bihar,Bhagalpur,Exotic,6090,2719,2162,2256,2496,2863,18586,58793,47938,87504,31627,11536,7249,244647,263233
Bihar,Bhagalpur,Indigenous(Desi),9148,1760,2654,1814,1807,2586,19769,94393,83068,107295,41796,17723,9274,353549,373318
Bihar,Bhojpur,Exotic,2171,162,88,28,10,6,2465,25600,20785,47442,14530,3133,299,111789,114254
Bihar,Bhojpur,Indigenous(Desi),2991,180,287,24,75,17,3574,39741,30186,63879,19580,3772,753,157911,161485
Bihar,Buxar,Exotic,2098,639,681,521,299,244,4482,27289,26049,43084,19957,2360,456,119195,123677
Bihar,Buxar,Indigenous(Desi),912,137,174,50,56,144,1473,18419,20020,23263,13902,1661,671,77936,79409
Bihar,Darbhanga,Exotic,1749,324,251,82,45,25,2476,23463,15819,27770,11367,1392,481,80292,82768
Bihar,Darbhanga,Indigenous(Desi),5409,1157,3400,214,278,260,10718,68078,53833,76020,32825,3827,3654,238237,248955
Bihar,Gaya,Exotic,1675,135,267,75,10,90,2252,14340,7310,20405,5608,1447,516,49626,51878
Bihar,Gaya,Indigenous(Desi),44133,5085,63364,4758,2382,2848,122570,175689,140030,205700,98932,19873,15711,655935,778505
Bihar,Gopalganj,Exotic,1998,133,438,78,79,188,2914,23550,16324,25878,13679,1323,425,81179,84093
Bihar,Gopalganj,Indigenous(Desi),4042,205,1837,572,432,552,7640,46728,28851,49074,25549,3614,1698,155514,163154
Bihar,Jamui,Exotic,3012,386,438,463,397,394,5090,6641,4118,8112,2054,358,309,21592,26682
Bihar,Jamui,Indigenous(Desi),29955,13371,38166,9684,4917,3949,100042,131287,110885,151198,73682,20768,21721,509541,609583
Bihar,Jehanabad,Exotic,1657,60,371,13,0,1,2102,9465,11069,16180,5028,310,98,42150,44252
Bihar,Jehanabad,Indigenous(Desi),2595,42,1351,46,7,23,4064,12072,8231,15873,6270,296,93,42835,46899
Bihar,Kaimur (Bhabua),Exotic,2477,228,223,15,5,99,3047,18699,9442,33400,7520,2651,594,72306,75353
Bihar,Kaimur (Bhabua),Indigenous(Desi),6933,448,4891,222,122,137,12753,36244,28647,59722,24249,5524,1901,156287,169040
Bihar,Katihar,Exotic,1034,278,186,119,76,77,1770,11969,8285,12859,5794,2121,286,41314,43084
Bihar,Katihar,Indigenous(Desi),39704,6095,12553,3436,1949,2900,66637,180208,146486,186724,79745,13073,7546,613782,680419
Bihar,Khagaria,Exotic,4748,1017,629,449,440,1592,8875,53584,39812,66719,17839,6928,1205,186087,194962
Bihar,Khagaria,Indigenous(Desi),3136,341,270,114,86,260,4207,26003,17600,32072,14426,5256,3149,98506,102713
Bihar,Kishanganj,Exotic,660,450,499,372,331,322,2634,1593,656,1646,500,512,193,5100,7734
Bihar,Kishanganj,Indigenous(Desi),42210,19890,22988,10056,10226,6699,112069,141397,104948,143070,41829,27542,8586,467372,579441
Bihar,Lakhisarai,Exotic,1495,98,247,50,20,16,1926,24841,16960,30681,13617,2235,577,88911,90837
Bihar,Lakhisarai,Indigenous(Desi),1518,52,893,54,22,11,2550,13127,8793,14806,7284,1753,420,46183,48733
Bihar,Madhepura,Exotic,2127,247,237,92,80,62,2845,19604,14793,20809,9589,3096,1374,69265,72110
Bihar,Madhepura,Indigenous(Desi),19260,1625,8500,1151,646,379,31561,99708,85522,118263,54019,9790,1798,369100,400661
Bihar,Madhubani,Exotic,1673,282,400,225,62,28,2670,10215,8211,11071,2289,527,449,32762,35432
Bihar,Madhubani,Indigenous(Desi),20179,4228,41131,2550,1806,1436,71330,137210,117843,145095,60068,10711,11020,481947,553277
Bihar,Munger,Exotic,1726,491,141,52,2,106,2518,12942,8230,19447,7301,512,396,48828,51346
Bihar,Munger,Indigenous(Desi),5856,598,3081,447,122,133,10237,43574,31369,44630,17811,1752,1359,140495,150732
Bihar,Muzaffarpur,Exotic,7478,1336,1285,441,439,296,11275,66220,37312,77490,27650,6174,1833,216679,227954
Bihar,Muzaffarpur,Indigenous(Desi),5305,1205,2842,744,319,372,10787,53892,42336,61017,24493,3641,1681,187060,197847
Bihar,Nalanda,Exotic,3281,637,296,68,15,188,4485,20635,12533,26307,7288,1890,290,68943,73428
Bihar,Nalanda,Indigenous(Desi),6203,414,2595,282,165,598,10257,35395,22456,48967,16102,3614,553,127087,137344
Bihar,Nawada,Exotic,887,45,183,17,15,134,1281,6807,4900,9549,3375,370,86,25087,26368
Bihar,Nawada,Indigenous(Desi),26659,2540,33166,2401,1041,1132,66939,86576,67353,104429,44949,5555,2170,311032,377971
Bihar,Pashchim Champaran,Exotic,3244,167,568,195,646,74,4894,21070,11302,27227,6480,1586,316,67981,72875
Bihar,Pashchim Champaran,Indigenous(Desi),18697,2243,11823,2881,8188,779,44611,88158,61531,98710,37280,5816,2222,293717,338328
Bihar,Patna,Exotic,3264,506,569,372,279,167,5157,79296,49742,132406,42008,4807,3420,311679,316836
Bihar,Patna,Indigenous(Desi),2749,295,300,70,87,128,3629,29303,25999,52102,20007,2981,2140,132532,136161
Bihar,Purbi Champaran,Exotic,5338,494,492,89,310,2607,9330,20718,11817,22989,8417,578,556,65075,74405
Bihar,Purbi Champaran,Indigenous(Desi),11414,1280,5436,1215,1481,683,21509,95120,56532,101589,45680,5961,2873,307755,329264
Bihar,Purnia,Exotic,1261,296,330,157,72,117,2233,6707,5337,8275,2853,548,480,24200,26433
Bihar,Purnia,Indigenous(Desi),49640,11744,11146,3983,2514,1481,80508,208765,165963,217834,97529,14257,5209,709557,790065
Bihar,Rohtas,Exotic,2509,342,54,31,17,11,2964,25395,20426,37560,13002,2697,1051,100131,103095
Bihar,Rohtas,Indigenous(Desi),7020,634,1317,178,32,136,9317,52974,54793,77444,39180,7321,3425,235137,244454
Bihar,Saharsa,Exotic,1538,463,355,80,33,63,2532,16298,13112,17194,6487,1183,738,55012,57544
Bihar,Saharsa,Indigenous(Desi),11032,3025,7611,3504,3090,554,28816,102010,87375,107901,36708,6303,2837,343134,371950
Bihar,Samastipur,Exotic,6008,405,936,713,262,115,8439,126079,76540,181965,76227,6532,2365,469708,478147
Bihar,Samastipur,Indigenous(Desi),756,81,645,170,96,23,1771,13196,10367,17886,7530,560,318,49857,51628
Bihar,Saran,Exotic,4122,215,495,114,216,114,5276,58133,39653,82076,34459,5392,1721,221434,226710
Bihar,Saran,Indigenous(Desi),3233,218,1274,139,148,457,5469,50630,42425,61545,33057,1737,1845,191239,196708
Bihar,Sheikhpura,Exotic,3451,97,254,41,66,95,4004,19049,10282,23353,4594,1294,668,59240,63244
Bihar,Sheikhpura,Indigenous(Desi),1396,90,466,76,39,93,2160,5285,3839,6725,1686,290,132,17957,20117
Bihar,Sheohar,Exotic,202,15,53,8,79,5,362,5809,3448,4326,1278,77,2452,17390,17752
Bihar,Sheohar,Indigenous(Desi),355,22,885,213,203,6,1684,6692,2790,8760,2953,145,200,21540,23224
Bihar,Sitamarhi,Exotic,1648,618,836,195,120,268,3685,13688,9123,15575,4946,603,412,44347,48032
Bihar,Sitamarhi,Indigenous(Desi),6969,1238,8417,1489,1049,488,19650,33313,24246,40718,9157,2277,1792,111503,131153
Bihar,Siwan,Exotic,1356,181,252,167,168,84,2208,25986,24898,32475,13733,3599,2987,103678,105886
Bihar,Siwan,Indigenous(Desi),3745,434,1076,274,361,278,6168,75667,53038,80680,24005,5128,7108,245626,251794
Bihar,Supaul,Exotic,3066,250,360,124,72,50,3922,6048,4242,6595,2462,1636,1353,22336,26258
Bihar,Supaul,Indigenous(Desi),26203,5073,15592,2172,1488,1177,51705,161796,133028,177803,63703,15982,10506,562818,614523
Bihar,Vaishali,Exotic,3311,316,807,314,130,101,4979,61339,28801,87869,25368,4485,1363,209225,214204
Bihar,Vaishali,Indigenous(Desi),1233,161,394,57,120,22,1987,15617,9059,23451,6994,1237,344,56702,58689
Chandigarh,Chandigarh,Exotic,504,18,3,3,9,465,1002,1338,802,4037,1585,132,106,8000,9002
Chandigarh,Chandigarh,Indigenous(Desi),423,28,7,4,68,1119,1649,315,297,674,1164,166,173,2789,4438
Chhattisgarh,Balod,Exotic,606,64,145,24,15,27,881,744,558,1404,819,352,17,3894,4775
Chhattisgarh,Balod,Indigenous(Desi),48405,3448,61326,3251,3484,1574,121488,37737,43382,45746,64311,16388,2655,210219,331707
Chhattisgarh,Baloda Bazar,Exotic,865,28,182,6,1,53,1135,1059,683,2038,1029,185,21,5015,6150
Chhattisgarh,Baloda Bazar,Indigenous(Desi),86146,4795,81043,2622,4941,8148,187695,52112,62309,65496,109985,27604,3160,320666,508361
Chhattisgarh,Balrampur,Exotic,614,15,798,31,2,13,1473,1070,719,1528,765,443,138,4663,6136
Chhattisgarh,Balrampur,Indigenous(Desi),29827,4389,212532,12761,1486,2781,263776,40935,29493,53358,45479,18847,3339,191451,455227
Chhattisgarh,Bastar,Exotic,809,62,301,65,35,41,1313,1321,851,2254,805,337,124,5692,7005
Chhattisgarh,Bastar,Indigenous(Desi),26231,2163,126957,9988,5144,1955,172438,18685,19656,26787,28757,7856,4377,106118,278556
Chhattisgarh,Bemetara,Exotic,236,14,73,8,65,1,397,213,183,337,222,88,1,1044,1441
Chhattisgarh,Bemetara,Indigenous(Desi),57028,7274,39055,2086,11516,1724,118683,49834,57812,68142,86613,31972,3440,297813,416496
Chhattisgarh,Bijapur,Exotic,68,15,22,3,0,0,108,82,48,124,68,9,0,331,439
Chhattisgarh,Bijapur,Indigenous(Desi),21816,7854,72683,26331,1997,294,130975,24159,26274,34129,47305,8662,499,141028,272003
Chhattisgarh,Bilaspur,Exotic,1728,421,637,177,175,219,3357,2166,1793,5563,2151,945,106,12724,16081
Chhattisgarh,Bilaspur,Indigenous(Desi),65850,9957,151678,5665,7556,5488,246194,61429,60772,82916,94985,39892,4450,344444,590638
Chhattisgarh,Dantewada,Exotic,291,12,67,12,9,4,395,429,281,952,197,152,12,2023,2418
Chhattisgarh,Dantewada,Indigenous(Desi),19975,1933,62669,18624,361,1256,104818,13495,14255,16537,28908,6517,682,80394,185212
Chhattisgarh,Dhamtari,Exotic,1098,16,204,1,9,16,1344,1282,1407,2003,1719,346,42,6799,8143
Chhattisgarh,Dhamtari,Indigenous(Desi),39101,553,44865,597,2533,856,88505,25692,37118,32392,51520,10062,1363,158147,246652
Chhattisgarh,Durg,Exotic,863,121,36,8,6,24,1058,1372,1272,4513,2027,594,41,9819,10877
Chhattisgarh,Durg,Indigenous(Desi),46479,5032,29629,1050,1766,4269,88225,39855,37338,51566,60726,17980,1126,208591,296816
Chhattisgarh,Gariyaband,Exotic,512,65,263,4,42,4,890,481,582,661,642,168,23,2557,3447
Chhattisgarh,Gariyaband,Indigenous(Desi),25502,4104,78166,2036,4738,919,115465,22166,26180,30948,42404,11403,1656,134757,250222
Chhattisgarh,Janjgir-Champa,Exotic,1604,134,985,56,115,165,3059,2237,1503,3451,2082,1031,271,10575,13634
Chhattisgarh,Janjgir-Champa,Indigenous(Desi),70431,11183,41571,4216,3201,10053,140655,61768,70544,81585,101870,35869,8382,360018,500673
Chhattisgarh,Jashpur,Exotic,760,16,723,40,7,9,1555,1321,851,2036,982,431,123,5744,7299
Chhattisgarh,Jashpur,Indigenous(Desi),30510,2620,251195,3793,1190,1930,291238,24614,24209,38302,35510,9291,2574,134500,425738
Chhattisgarh,Kabirdham (Kawardha),Exotic,166,130,162,50,31,1,540,70,83,114,112,61,10,450,990
Chhattisgarh,Kabirdham (Kawardha),Indigenous(Desi),40752,9225,58976,5976,2773,1292,118994,42375,44863,51820,68457,27701,3478,238694,357688
Chhattisgarh,Kanker,Exotic,1903,98,752,205,26,36,3020,3430,2266,4379,3073,1050,87,14285,17305
Chhattisgarh,Kanker,Indigenous(Desi),35991,1283,141566,4785,460,904,184989,27821,21649,33064,46060,11129,1312,141035,326024
Chhattisgarh,Kondagaon,Exotic,533,54,549,19,0,8,1163,492,369,969,616,213,11,2670,3833
Chhattisgarh,Kondagaon,Indigenous(Desi),21884,2979,193909,8695,926,700,229093,17556,16935,22672,37538,10309,1640,106650,335743
Chhattisgarh,Korba,Exotic,650,94,143,40,10,58,995,1329,1007,1999,843,338,75,5591,6586
Chhattisgarh,Korba,Indigenous(Desi),30968,5515,126660,13183,1887,1807,180020,27336,28927,39656,52688,16478,2110,167195,347215
Chhattisgarh,Korea,Exotic,939,92,1573,40,14,36,2694,2188,1216,2966,1221,276,68,7935,10629
Chhattisgarh,Korea,Indigenous(Desi),32131,7606,143738,11105,5090,3015,202685,34976,32333,44739,42406,10309,2785,167548,370233
Chhattisgarh,Mahasamund,Exotic,3262,169,1567,49,33,94,5174,5537,3260,8279,3428,1402,154,22060,27234
Chhattisgarh,Mahasamund,Indigenous(Desi),35760,3688,79045,937,1858,2631,123919,30128,27426,39515,44816,10803,1311,153999,277918
Chhattisgarh,Mungeli,Exotic,182,7,37,0,29,3,258,427,344,702,457,117,12,2059,2317
Chhattisgarh,Mungeli,Indigenous(Desi),33053,1115,32707,675,10485,819,78854,30058,40488,34953,61716,13163,1821,182199,261053
Chhattisgarh,Narayanpur,Exotic,110,1,4,142,0,1,258,105,120,140,128,52,4,549,807
Chhattisgarh,Narayanpur,Indigenous(Desi),20386,667,14810,46144,963,997,83967,19272,16051,25954,30428,13044,2623,107372,191339
Chhattisgarh,Raigarh,Exotic,5959,272,3550,102,305,171,10359,7568,5445,13333,7183,3662,152,37343,47702
Chhattisgarh,Raigarh,Indigenous(Desi),36818,1610,126707,3598,2515,2154,173402,29263,30921,46086,37515,12918,1221,157924,331326
Chhattisgarh,Raipur,Exotic,1203,178,86,14,23,43,1547,2457,2011,5176,2008,668,61,12381,13928
Chhattisgarh,Raipur,Indigenous(Desi),47225,5834,33782,1920,8282,4861,101904,42859,40610,56145,68084,18012,2083,227793,329697
Chhattisgarh,Rajnandgaon,Exotic,567,46,155,29,51,95,943,696,726,2099,993,177,80,4771,5714
Chhattisgarh,Rajnandgaon,Indigenous(Desi),106219,7773,183005,4747,19880,13441,335065,69615,80962,92338,129631,26451,6424,405421,740486
Chhattisgarh,Sukma,Exotic,52,10,16,5,4,4,91,55,42,106,23,25,10,261,352
Chhattisgarh,Sukma,Indigenous(Desi),37615,18514,100965,24229,8838,12390,202551,35264,49987,37992,29571,21393,11957,186164,388715
Chhattisgarh,Surajpur,Exotic,1645,125,1984,92,52,24,3922,2448,1889,3893,2491,656,80,11457,15379
Chhattisgarh,Surajpur,Indigenous(Desi),20190,4365,207114,10409,774,1418,244270,23477,21628,30656,36013,6413,832,119019,363289
Chhattisgarh,Surguja,Exotic,2477,122,6723,85,14,16,9437,3878,2835,5274,3621,1241,118,16967,26404
Chhattisgarh,Surguja,Indigenous(Desi),17742,2197,219701,4133,205,796,244774,18290,12987,24373,28560,7994,924,93128,337902
Dadra And Nagar Haveli,Dadra And Nagar Haveli,Exotic,273,30,11,12,79,20,425,141,103,389,99,13,0,745,1170
Dadra And Nagar Haveli,Dadra And Nagar Haveli,Indigenous(Desi),18199,4248,3094,327,191,308,26367,6084,2914,1576,1312,232,81,12199,38566
Daman And Diu,Daman,Exotic,21,2,3,2,4,10,42,28,33,84,53,4,0,202,244
Daman And Diu,Daman,Indigenous(Desi),46,11,92,20,10,59,238,53,73,104,84,29,16,359,597
Daman And Diu,Diu,Indigenous(Desi),111,2,91,0,0,49,253,124,187,150,230,7,48,746,999
Goa,North Goa,Exotic,408,63,26,18,0,26,541,2398,1914,6114,2356,680,50,13512,14053
Goa,North Goa,Indigenous(Desi),1264,387,960,475,28,355,3469,2038,1665,3148,1979,463,141,9434,12903
Goa,South Goa,Exotic,745,101,65,43,9,133,1096,2332,2209,5492,1845,353,149,12380,13476
Goa,South Goa,Indigenous(Desi),2064,744,3837,461,182,826,8114,2275,2347,3366,2715,628,370,11701,19815
Gujarat,AHMADABAD,Exotic,1209,97,82,19,12,92,1511,4135,3771,8566,3145,439,152,20208,21719
Gujarat,AHMADABAD,Indigenous(Desi),6695,1200,809,174,330,1161,10369,36380,33230,63868,36462,8093,1856,179889,190258
Gujarat,AMRELI,Exotic,30,2,5,0,0,2,39,316,196,763,147,23,0,1445,1484
Gujarat,AMRELI,Indigenous(Desi),7774,1039,34158,503,5026,1115,49615,35469,28356,65156,21871,3491,1799,156142,205757
Gujarat,ANAND,Exotic,3230,242,220,15,32,29,3768,31965,33818,86238,23435,5302,421,181179,184947
Gujarat,ANAND,Indigenous(Desi),3512,357,3654,95,178,25,7821,15303,16374,32499,15030,1296,235,80737,88558
Gujarat,ARVALLI,Exotic,7701,155,1091,32,38,72,9089,55940,48574,114427,42506,7247,361,269055,278144
Gujarat,ARVALLI,Indigenous(Desi),5532,322,58595,299,2121,18,66887,18067,14208,28136,17041,2250,299,80001,146888
Gujarat,BANAS KANTHA,Exotic,31308,901,580,181,227,49,33246,173077,204284,375658,111318,13178,1419,878934,912180
Gujarat,BANAS KANTHA,Indigenous(Desi),37706,5460,37715,1117,3597,1096,86691,79633,85271,136484,75470,10246,4382,391486,478177
Gujarat,BHARUCH,Exotic,894,201,450,504,113,281,2443,6959,7176,10902,3271,950,390,29648,32091
Gujarat,BHARUCH,Indigenous(Desi),5445,1572,5654,985,836,936,15428,20011,18539,24929,7976,2082,1288,74825,90253
Gujarat,BHAVNAGAR,Exotic,270,68,420,36,11,341,1146,1200,885,2374,734,188,61,5442,6588
Gujarat,BHAVNAGAR,Indigenous(Desi),8542,2643,27091,846,2012,3187,44321,39351,31912,66948,28154,5885,3248,175498,219819
Gujarat,BOTAD,Exotic,506,35,6,25,2,0,574,1865,1574,3861,1165,200,16,8681,9255
Gujarat,BOTAD,Indigenous(Desi),8297,1607,6919,161,162,247,17393,34011,32621,53410,24853,3088,716,148699,166092
Gujarat,CHHOTAUDEPUR,Exotic,3593,49,1161,80,10,4,4897,9870,7205,16966,9519,1257,20,44837,49734
Gujarat,CHHOTAUDEPUR,Indigenous(Desi),19773,2457,140160,6825,1965,161,171341,22970,18016,35841,23631,2579,105,103142,274483
Gujarat,DANG,Exotic,1727,65,797,0,113,24,2726,3139,3973,8168,2078,245,7,17610,20336
Gujarat,DANG,Indigenous(Desi),3625,1694,24510,153,6995,100,37077,3038,4254,6037,3904,250,5,17488,54565
Gujarat,DEVBHUMI DWARKA,Exotic,30,80,18,9,0,0,137,130,113,403,98,24,39,807,944
Gujarat,DEVBHUMI DWARKA,Indigenous(Desi),3533,1053,15670,1446,6240,306,28248,19808,20448,35120,14416,4498,2544,96834,125082
Gujarat,DOHAD,Exotic,657,48,497,49,35,64,1350,1837,1390,3070,1134,224,55,7710,9060
Gujarat,DOHAD,Indigenous(Desi),64061,11260,258609,13347,19531,2763,369571,64302,60917,89383,48797,10694,3499,277592,647163
Gujarat,GANDHINAGAR,Exotic,2488,123,133,14,15,9,2782,19750,16940,49041,13277,3727,292,103027,105809
Gujarat,GANDHINAGAR,Indigenous(Desi),4027,552,5785,53,2400,61,12878,11873,10145,27134,13563,3175,159,66049,78927
Gujarat,GIR SOMNATH,Exotic,176,164,44,0,4,1,389,3406,2365,6272,1026,188,84,13341,13730
Gujarat,GIR SOMNATH,Indigenous(Desi),6423,766,22151,440,4943,110,34833,42764,30231,67164,19571,2547,1686,163963,198796
Gujarat,JAMNAGAR,Exotic,57,0,0,0,0,0,57,148,90,422,94,6,0,760,817
Gujarat,JAMNAGAR,Indigenous(Desi),4563,596,46345,166,3022,285,54977,18562,15903,38214,9561,764,378,83382,138359
Gujarat,JUNAGADH,Exotic,80,9,7,4,2,0,102,359,235,752,227,39,0,1612,1714
Gujarat,JUNAGADH,Indigenous(Desi),7873,1416,41420,236,3757,577,55279,21663,20376,41360,19512,4701,1164,108776,164055
Gujarat,KACHCHH,Exotic,1015,84,5,14,1,142,1261,4451,3426,8177,2540,1366,313,20273,21534
Gujarat,KACHCHH,Indigenous(Desi),46631,9018,5725,628,2350,8644,72996,103200,96207,162171,97128,15190,6411,480307,553303
Gujarat,KHEDA,Exotic,4949,252,493,33,29,196,5952,32145,36619,69383,22897,3571,383,164998,170950
Gujarat,KHEDA,Indigenous(Desi),4036,312,9840,61,344,148,14741,12934,17510,31532,15172,2345,276,79769,94510
Gujarat,MAHESANA,Exotic,4176,445,2270,732,60,55,7738,40203,36989,90611,20295,3998,239,192335,200073
Gujarat,MAHESANA,Indigenous(Desi),5224,806,7696,396,2374,398,16894,18685,20732,43946,19613,3287,628,106891,123785
Gujarat,MORBI,Exotic,75,12,10,0,0,0,97,986,989,2232,690,21,3,4921,5018
Gujarat,MORBI,Indigenous(Desi),6806,790,4921,48,1342,103,14010,28318,22743,45113,24661,1975,146,122956,136966
Gujarat,Mahisagar,Exotic,2496,44,765,14,237,21,3577,31452,37661,76975,24666,3870,386,175010,178587
Gujarat,Mahisagar,Indigenous(Desi),6479,334,40222,13096,823,79,61033,12743,15610,24814,12007,2641,673,68488,129521
Gujarat,NARMADA,Exotic,1136,37,342,9,4,37,1565,2193,2070,4516,2085,356,36,11256,12821
Gujarat,NARMADA,Indigenous(Desi),18391,2003,69596,2694,446,597,93727,12259,15256,18572,22464,2035,416,71002,164729
Gujarat,NAVSARI,Exotic,10625,109,292,56,45,63,11190,42593,40419,78702,31001,9462,442,202619,213809
Gujarat,NAVSARI,Indigenous(Desi),1258,65,5128,102,297,77,6927,1911,2019,3937,2214,689,38,10808,17735
Gujarat,PANCH MAHALS,Exotic,2432,584,1506,57,14,28,4621,10096,10082,18327,6889,1558,495,47447,52068
Gujarat,PANCH MAHALS,Indigenous(Desi),14049,6360,98031,1200,371,357,120368,31876,38293,56644,30181,3734,2056,162784,283152
Gujarat,PATAN,Exotic,1941,61,39,14,28,1,2084,9603,9360,21164,6699,1017,56,47899,49983
Gujarat,PATAN,Indigenous(Desi),9617,671,3136,293,985,1643,16345,20569,21863,36261,23870,4099,670,107332,123677
Gujarat,PORBANDAR,Exotic,101,8,229,9,1,1,349,372,1104,1293,428,148,121,3466,3815
Gujarat,PORBANDAR,Indigenous(Desi),1697,236,8639,84,1380,134,12170,8969,9397,20047,7973,1407,687,48480,60650
Gujarat,RAJKOT,Exotic,1618,233,346,9,4,285,2495,12103,9262,20092,7432,1477,99,50465,52960
Gujarat,RAJKOT,Indigenous(Desi),14813,2191,64475,882,5207,1052,88620,51718,45150,93123,37218,7552,944,235705,324325
Gujarat,SABAR KANTHA,Exotic,4717,161,785,27,39,2,5731,55748,50893,129089,32743,9577,1081,279131,284862
Gujarat,SABAR KANTHA,Indigenous(Desi),8109,4472,46970,3405,417,149,63522,23906,22677,40634,19365,4468,487,111537,175059
Gujarat,SURAT,Exotic,4296,402,985,265,450,266,6664,34408,36937,59871,15251,4367,977,151811,158475
Gujarat,SURAT,Indigenous(Desi),5997,1081,12465,1176,1040,1985,23744,17626,20025,33156,13409,3830,1598,89644,113388
Gujarat,SURENDRANAGAR,Exotic,298,21,25,23,21,10,398,1475,1108,2987,1033,156,28,6787,7185
Gujarat,SURENDRANAGAR,Indigenous(Desi),17389,3685,13275,206,164,969,35688,60931,57479,98859,54455,9496,1587,282807,318495
Gujarat,TAPI,Exotic,6687,102,1482,79,14,653,9017,28960,30941,52107,26336,7128,749,146221,155238
Gujarat,TAPI,Indigenous(Desi),7182,785,31643,775,2394,182,42961,4764,6455,7827,5381,1368,134,25929,68890
Gujarat,VADODARA,Exotic,1696,124,116,50,27,12,2025,7723,6557,17607,5070,919,139,38015,40040
Gujarat,VADODARA,Indigenous(Desi),5729,850,8050,558,1249,188,16624,19017,17858,40779,15357,2935,370,96316,112940
Gujarat,VALSAD,Exotic,6056,287,1256,153,127,38,7917,30675,30432,59466,19129,2886,714,143302,151219
Gujarat,VALSAD,Indigenous(Desi),12408,5140,58508,7118,1928,1603,86705,15053,18307,15577,19217,2264,968,71386,158091
Haryana,AMBALA,Exotic,2707,138,722,132,507,272,4478,10972,7099,23796,6931,1621,630,51049,55527
Haryana,AMBALA,Indigenous(Desi),959,55,847,31,932,317,3141,2589,2200,4746,2163,573,221,12492,15633
Haryana,BHIWANI,Exotic,2516,23,302,25,296,826,3988,7369,5521,12867,3897,855,347,30856,34844
Haryana,BHIWANI,Indigenous(Desi),5699,280,3942,386,3710,3645,17662,12255,9829,18480,8344,1813,2147,52868,70530
Haryana,CHARKI DADRI,Exotic,1014,28,82,24,135,116,1399,4104,3702,7391,1353,454,135,17139,18538
Haryana,CHARKI DADRI,Indigenous(Desi),1529,142,976,65,1638,136,4486,3702,3076,5877,1849,369,515,15388,19874
Haryana,FARIDABAD,Exotic,636,78,127,64,119,254,1278,3925,2131,7860,2031,641,516,17104,18382
Haryana,FARIDABAD,Indigenous(Desi),1047,138,186,78,132,355,1936,4810,2853,9454,3260,1076,1217,22670,24606
Haryana,FATEHABAD,Exotic,4739,183,151,13,270,2048,7404,8304,8829,16314,5803,1302,910,41462,48866
Haryana,FATEHABAD,Indigenous(Desi),6895,332,3255,154,2630,3560,16826,8761,10274,12496,7437,1492,2648,43108,59934
Haryana,GURUGRAM,Exotic,2798,70,81,43,355,1475,4822,8093,5187,14591,5521,614,843,34849,39671
Haryana,GURUGRAM,Indigenous(Desi),1309,104,45,41,391,1086,2976,4900,3872,6592,4498,702,705,21269,24245
Haryana,HISAR,Exotic,5545,196,193,7,287,2216,8444,11212,9246,18842,5814,1225,1602,47941,56385
Haryana,HISAR,Indigenous(Desi),11196,572,10848,790,10714,5849,39969,16851,14307,22575,12704,2387,4349,73173,113142
Haryana,JHAJJAR,Exotic,2160,573,43,6,72,239,3093,6167,3557,10699,2261,493,610,23787,26880
Haryana,JHAJJAR,Indigenous(Desi),3619,798,699,106,1507,1426,8155,6242,5457,8315,4406,1154,1965,27539,35694
Haryana,JIND,Exotic,1773,284,206,33,298,872,3466,4286,3351,8100,2828,617,273,19455,22921
Haryana,JIND,Indigenous(Desi),8973,1584,11922,1046,15906,3736,43167,11239,9396,15517,10179,1650,2555,50536,93703
Haryana,KAITHAL,Exotic,2008,26,283,158,214,668,3357,7534,5642,14619,4463,983,387,33628,36985
Haryana,KAITHAL,Indigenous(Desi),6238,701,4608,893,3005,2694,18139,8065,6894,10789,7295,1393,2383,36819,54958
Haryana,KARNAL,Exotic,6152,133,603,533,538,1187,9146,22436,18044,47603,13370,5520,504,107477,116623
Haryana,KARNAL,Indigenous(Desi),3630,298,778,489,631,486,6312,6749,6007,11263,6331,1331,579,32260,38572
Haryana,KURUKSHETRA,Exotic,4171,186,409,160,380,533,5839,16043,13368,33855,8709,4019,907,76901,82740
Haryana,KURUKSHETRA,Indigenous(Desi),1320,118,279,75,468,518,2778,2972,3253,5807,3204,822,362,16420,19198
Haryana,MAHENDRAGARH,Exotic,1186,177,13,0,37,268,1681,4274,3939,8037,2034,581,472,19337,21018
Haryana,MAHENDRAGARH,Indigenous(Desi),3107,531,169,98,612,1426,5943,5225,5734,6916,3756,1499,1022,24152,30095
Haryana,MEWAT,Exotic,678,22,84,7,21,152,964,2417,1273,3957,859,269,177,8952,9916
Haryana,MEWAT,Indigenous(Desi),1175,209,132,24,55,1127,2722,3982,2915,5584,2645,924,1122,17172,19894
Haryana,PALWAL,Exotic,1548,79,187,34,363,212,2423,4862,2525,9786,2773,683,447,21076,23499
Haryana,PALWAL,Indigenous(Desi),1999,158,522,62,1128,237,4106,5281,3645,8459,3240,881,573,22079,26185
Haryana,PANCHKULA,Exotic,660,13,472,66,176,96,1483,2177,1961,5430,1705,284,175,11732,13215
Haryana,PANCHKULA,Indigenous(Desi),1293,82,4156,117,646,231,6525,2046,2609,4592,2669,537,188,12641,19166
Haryana,PANIPAT,Exotic,2934,124,320,109,251,393,4131,8173,5289,16695,3990,1059,461,35667,39798
Haryana,PANIPAT,Indigenous(Desi),3618,568,665,112,425,2366,7754,6358,4994,8434,5245,1333,845,27209,34963
Haryana,REWARI,Exotic,1491,60,11,8,17,180,1767,4883,4002,9528,2035,630,40,21118,22885
Haryana,REWARI,Indigenous(Desi),2548,90,125,21,248,385,3417,4075,4329,6172,2561,546,325,18008,21425
Haryana,ROHTAK,Exotic,1656,95,204,142,115,1052,3264,3688,2084,6808,2702,455,214,15951,19215
Haryana,ROHTAK,Indigenous(Desi),4857,700,2430,298,3391,3840,15516,7043,4917,7407,5262,2264,2451,29344,44860
Haryana,SIRSA,Exotic,9733,640,653,45,566,4713,16350,21354,20844,42472,13947,5155,2157,105929,122279
Haryana,SIRSA,Indigenous(Desi),11383,1113,2805,317,5259,4523,25400,18968,19768,28649,13761,3944,2593,87683,113083
Haryana,SONIPAT,Exotic,3682,218,124,82,175,1809,6090,12146,8198,21860,6694,1080,890,50868,56958
Haryana,SONIPAT,Indigenous(Desi),5745,537,1199,382,1474,4026,13363,9356,7282,10546,7892,2665,3396,41137,54500
Haryana,YAMUNANAGAR,Exotic,2261,51,417,209,188,77,3203,18929,14645,37605,13026,3823,765,88793,91996
Haryana,YAMUNANAGAR,Indigenous(Desi),535,36,398,70,98,36,1173,3004,2522,5746,1970,640,226,14108,15281
Himachal Pradesh,Bilaspur,Exotic,1037,14,1523,22,2,27,2625,6062,4179,15221,3005,597,78,29142,31767
Himachal Pradesh,Bilaspur,Indigenous(Desi),540,46,9851,66,34,101,10638,373,318,1127,410,125,18,2371,13009
Himachal Pradesh,Chamba,Exotic,3714,81,8322,473,4,15,12609,10406,5733,24976,7224,1288,130,49757,62366
Himachal Pradesh,Chamba,Indigenous(Desi),15240,822,67342,9485,62,351,93302,20025,13932,42351,26987,2638,338,106271,199573
Himachal Pradesh,Hamirpur,Exotic,709,65,1056,17,13,143,2003,2807,2155,8729,1676,389,178,15934,17937
Himachal Pradesh,Hamirpur,Indigenous(Desi),70,22,1079,7,13,1,1192,88,105,289,129,39,10,660,1852
Himachal Pradesh,Kangra,Exotic,12096,240,12885,417,158,816,26612,38800,30949,98334,28791,4814,1107,202795,229407
Himachal Pradesh,Kangra,Indigenous(Desi),3101,249,35470,319,722,554,40415,4448,3569,10275,6794,766,285,26137,66552
Himachal Pradesh,Kinnaur,Exotic,803,38,179,46,0,36,1102,2807,1776,7232,2173,436,50,14474,15576
Himachal Pradesh,Kinnaur,Indigenous(Desi),507,23,413,84,4,43,1074,954,762,2416,1417,259,37,5845,6919
Himachal Pradesh,Kullu,Exotic,4128,133,5964,326,23,209,10783,19385,11684,58623,11583,2445,553,104273,115056
Himachal Pradesh,Kullu,Indigenous(Desi),3277,318,10188,1126,156,118,15183,4887,2514,12223,3775,1138,333,24870,40053
Himachal Pradesh,Lahul And Spiti,Exotic,178,25,115,19,38,8,383,1012,1093,3937,871,218,4,7135,7518
Himachal Pradesh,Lahul And Spiti,Indigenous(Desi),219,4,729,101,3,0,1056,224,435,1819,540,85,1,3104,4160
Himachal Pradesh,Mandi,Exotic,7658,141,11169,354,72,272,19666,37715,29488,109493,25931,5390,1100,209117,228783
Himachal Pradesh,Mandi,Indigenous(Desi),7081,446,60005,431,814,377,69154,9348,7916,26490,15112,1917,576,61359,130513
Himachal Pradesh,Shimla,Exotic,7059,215,3360,254,7,231,11126,23398,14960,73264,16465,3325,665,132077,143203
Himachal Pradesh,Shimla,Indigenous(Desi),5634,349,19011,1184,101,251,26530,8910,6343,21694,11714,1301,481,50443,76973
Himachal Pradesh,Sirmaur,Exotic,4753,104,3566,247,12,123,8805,15282,10136,32465,11323,2727,477,72410,81215
Himachal Pradesh,Sirmaur,Indigenous(Desi),13315,475,44659,2037,37,837,61360,20794,14101,43069,20111,4144,903,103122,164482
Himachal Pradesh,Solan,Exotic,2348,55,4260,56,16,253,6988,12734,10248,41060,8315,1962,370,74689,81677
Himachal Pradesh,Solan,Indigenous(Desi),1762,195,24146,222,50,403,26778,2823,2767,10097,5535,785,274,22281,49059
Himachal Pradesh,Una,Exotic,3013,91,1260,39,9,262,4674,10291,9302,22861,6141,989,172,49756,54430
Himachal Pradesh,Una,Indigenous(Desi),468,40,1843,54,20,105,2530,583,591,1367,674,121,71,3407,5937
Jammu And Kashmir,Anantnag,Exotic,21821,509,2718,398,45,418,25909,37953,15651,74486,4896,3788,836,137610,163519
Jammu And Kashmir,Anantnag,Indigenous(Desi),4138,59,981,113,3,332,5626,4303,2147,9383,1821,793,1019,19466,25092
Jammu And Kashmir,Badgam,Exotic,13783,340,2241,445,60,322,17191,31738,18568,63637,1855,3850,1917,121565,138756
Jammu And Kashmir,Badgam,Indigenous(Desi),535,2,355,6,8,17,923,1920,682,2620,45,28,179,5474,6397
Jammu And Kashmir,Bandipora,Exotic,6667,107,639,302,11,584,8310,11824,5892,23736,2400,989,1070,45911,54221
Jammu And Kashmir,Bandipora,Indigenous(Desi),2772,448,799,642,49,25,4735,4543,2795,8461,1298,721,114,17932,22667
Jammu And Kashmir,Baramulla,Exotic,17522,668,2272,2175,63,937,23637,28030,12264,56225,3162,2585,1051,103317,126954
Jammu And Kashmir,Baramulla,Indigenous(Desi),3880,75,1353,311,132,114,5865,6947,2519,11814,2240,881,505,24906,30771
Jammu And Kashmir,Doda,Exotic,2161,136,2903,311,10,10,5531,9368,4461,16305,3284,407,69,33894,39425
Jammu And Kashmir,Doda,Indigenous(Desi),9156,774,14826,6536,94,767,32153,22518,13641,45078,11535,1054,268,94094,126247
Jammu And Kashmir,Ganderbal,Exotic,5914,309,532,110,0,119,6984,8141,6106,19785,1190,750,219,36191,43175
Jammu And Kashmir,Ganderbal,Indigenous(Desi),2297,267,653,323,3,21,3564,3767,2084,6924,1513,554,46,14888,18452
Jammu And Kashmir,Jammu,Exotic,4907,331,832,998,175,137,7380,29050,21210,60429,16248,3301,1071,131309,138689
Jammu And Kashmir,Jammu,Indigenous(Desi),1596,286,3119,517,69,40,5627,9373,7872,16320,7127,1441,594,42727,48354
Jammu And Kashmir,Kargil,Exotic,1188,191,35,14,32,47,1507,6089,3208,13228,777,445,64,23811,25318
Jammu And Kashmir,Kargil,Indigenous(Desi),515,305,489,119,20,12,1460,3636,4320,10341,2359,750,178,21584,23044
Jammu And Kashmir,Kathua,Exotic,5471,295,2266,327,9,107,8475,17010,9901,29484,6194,887,1074,64550,73025
Jammu And Kashmir,Kathua,Indigenous(Desi),7386,400,38619,4899,58,229,51591,23382,11153,33468,13149,2571,547,84270,135861
Jammu And Kashmir,Kishtwar,Exotic,1100,233,751,384,34,7,2509,2709,1429,5471,1572,414,12,11607,14116
Jammu And Kashmir,Kishtwar,Indigenous(Desi),6091,770,10791,3347,142,45,21186,15006,7947,24383,9309,1634,148,58427,79613
Jammu And Kashmir,Kulgam,Exotic,20314,397,886,837,433,1881,24748,18879,10785,42653,3262,2332,2516,80427,105175
Jammu And Kashmir,Kulgam,Indigenous(Desi),448,13,24,3,10,30,528,1244,676,2400,380,10,3,4713,5241
Jammu And Kashmir,Kupwara,Exotic,8975,441,3442,1798,112,175,14943,23265,10646,34221,8059,3718,605,80514,95457
Jammu And Kashmir,Kupwara,Indigenous(Desi),10188,324,5983,3775,211,144,20625,16977,9564,25181,9219,4395,1580,66916,87541
Jammu And Kashmir,Leh Ladakh,Exotic,290,411,28,5,8,0,742,2091,2017,5517,2669,408,16,12718,13460
Jammu And Kashmir,Leh Ladakh,Indigenous(Desi),1049,991,2482,534,7,25,5088,2432,2972,6628,4586,657,16,17291,22379
Jammu And Kashmir,Poonch,Exotic,455,54,872,144,0,1,1526,3818,1274,7555,1129,185,20,13981,15507
Jammu And Kashmir,Poonch,Indigenous(Desi),1440,502,3849,1180,6,12,6989,8257,3049,15327,3462,974,89,31158,38147
Jammu And Kashmir,Pulwama,Exotic,15262,114,1412,46,10,262,17106,17968,13354,46566,1250,431,73,79642,96748
Jammu And Kashmir,Pulwama,Indigenous(Desi),59,16,25,4,3,0,107,73,73,226,7,0,0,379,486
Jammu And Kashmir,Rajauri,Exotic,2945,187,990,306,207,15,4650,11206,5838,19867,4970,538,249,42668,47318
Jammu And Kashmir,Rajauri,Indigenous(Desi),3219,539,10537,3635,88,80,18098,10693,4595,20483,5980,494,128,42373,60471
Jammu And Kashmir,Ramban,Exotic,2497,97,368,276,16,22,3276,7556,2203,8848,1158,842,217,20824,24100
Jammu And Kashmir,Ramban,Indigenous(Desi),5174,249,2609,8260,49,287,16628,28026,16614,35525,9598,3932,2002,95697,112325
Jammu And Kashmir,Reasi,Exotic,450,20,97,89,25,8,689,2666,1028,4257,810,237,43,9041,9730
Jammu And Kashmir,Reasi,Indigenous(Desi),4088,482,8306,6242,77,138,19333,19585,10792,26257,10981,1591,438,69644,88977
Jammu And Kashmir,Samba,Exotic,2794,149,595,213,103,102,3956,13518,8739,21259,5087,601,789,49993,53949
Jammu And Kashmir,Samba,Indigenous(Desi),1700,48,1941,331,5,68,4093,2989,2277,4714,1908,266,96,12250,16343
Jammu And Kashmir,Shopian,Exotic,9628,211,46,16,2,30,9933,17567,5967,32722,1035,1357,57,58705,68638
Jammu And Kashmir,Shopian,Indigenous(Desi),170,8,0,0,0,10,188,187,82,419,13,3,22,726,914
Jammu And Kashmir,Srinagar,Exotic,4636,164,95,159,3,87,5144,8219,4134,17802,752,767,192,31866,37010
Jammu And Kashmir,Srinagar,Indigenous(Desi),27,0,1,26,0,0,54,94,44,176,4,11,2,331,385
Jammu And Kashmir,Udhampur,Exotic,4223,326,3722,1160,17,197,9645,14870,5947,21721,5562,846,346,49292,58937
Jammu And Kashmir,Udhampur,Indigenous(Desi),9433,982,32643,17911,118,327,61414,20066,12808,32902,15802,2425,889,84892,146306
Jharkhand,Bokaro,Exotic,990,347,357,128,76,35,1933,5766,4483,10413,2244,319,256,23481,25414
Jharkhand,Bokaro,Indigenous(Desi),32377,8669,119401,6451,6964,1343,175205,49509,42931,64086,36714,5398,1684,200322,375527
Jharkhand,Chatra,Exotic,1522,469,639,407,212,368,3617,5916,3508,8089,3172,1010,1204,22899,26516
Jharkhand,Chatra,Indigenous(Desi),50866,27198,86284,16704,4703,8287,194042,66718,61774,81938,58341,12224,9084,290079,484121
Jharkhand,Deoghar,Exotic,1219,270,578,157,88,124,2436,7584,7150,13510,3695,757,496,33192,35628
Jharkhand,Deoghar,Indigenous(Desi),66733,11591,141215,9170,1862,6490,237061,95530,103601,126340,69958,13517,11063,420009,657070
Jharkhand,Dhanbad,Exotic,3293,326,395,87,33,129,4263,11132,6422,22833,4567,958,294,46206,50469
Jharkhand,Dhanbad,Indigenous(Desi),26024,3631,82523,2292,1006,833,116309,49400,37004,62324,28063,4408,1923,183122,299431
Jharkhand,Dumka,Exotic,688,184,432,199,69,110,1682,4325,2471,5808,1955,360,139,15058,16740
Jharkhand,Dumka,Indigenous(Desi),78868,17071,183962,19476,2875,4016,306268,119419,98248,130436,58052,13328,5133,424616,730884
Jharkhand,East Singhbum,Exotic,1248,394,250,114,203,143,2352,9522,6917,18990,1892,1550,473,39344,41696
Jharkhand,East Singhbum,Indigenous(Desi),29175,16302,76528,8307,81064,2889,214265,39913,32666,51806,22040,6910,3291,156626,370891
Jharkhand,Garhwa,Exotic,4134,2555,1811,466,81,64,9111,25316,19940,14041,2650,374,560,62881,71992
Jharkhand,Garhwa,Indigenous(Desi),42209,12616,123787,15625,2693,2099,199029,119766,98723,135685,61895,9754,4908,430731,629760
Jharkhand,Giridih,Exotic,2326,230,477,158,48,86,3325,7870,5270,10966,2647,618,236,27607,30932
Jharkhand,Giridih,Indigenous(Desi),96039,23269,210483,37829,23980,9275,400875,142139,120714,175975,72764,22202,8268,542062,942937
Jharkhand,Godda,Exotic,657,285,224,387,116,141,1810,3274,2614,3855,1257,201,215,11416,13226
Jharkhand,Godda,Indigenous(Desi),28505,6544,17420,10272,3589,4346,70676,161432,181666,172764,52809,14469,17611,600751,671427
Jharkhand,Gumla,Exotic,851,36,1806,349,4,600,3646,2190,1229,3198,1731,156,43,8547,12193
Jharkhand,Gumla,Indigenous(Desi),54040,4600,223117,10388,2067,5476,299688,55960,55132,67397,51364,13128,3386,246367,546055
Jharkhand,Hazaribagh,Exotic,1688,236,554,136,54,163,2831,6133,4341,9555,3748,468,260,24505,27336
Jharkhand,Hazaribagh,Indigenous(Desi),48214,4497,151399,4922,3063,9983,222078,70153,63252,86450,72349,4384,2410,298998,521076
Jharkhand,Jamtara,Exotic,376,18,223,7,5,10,639,1512,1136,2469,922,358,102,6499,7138
Jharkhand,Jamtara,Indigenous(Desi),41290,12830,117278,7799,4570,1029,184796,57462,59931,62834,48395,8703,2327,239652,424448
Jharkhand,Khunti,Exotic,547,80,530,81,20,21,1279,1310,961,2096,402,187,55,5011,6290
Jharkhand,Khunti,Indigenous(Desi),27588,10384,95730,7805,2255,2167,145929,30870,26327,43117,21031,4152,2101,127598,273527
Jharkhand,Koderma,Exotic,1933,308,830,1725,355,120,5271,4249,2828,8244,1811,232,79,17443,22714
Jharkhand,Koderma,Indigenous(Desi),15073,3228,49353,1639,554,958,70805,22305,21445,34448,9976,1424,534,90132,160937
Jharkhand,Latehar,Exotic,538,60,308,75,58,77,1116,2507,1519,3507,1667,202,172,9574,10690
Jharkhand,Latehar,Indigenous(Desi),32412,6097,120306,18213,2233,1961,181222,33755,30528,42009,42505,4223,3004,156024,337246
Jharkhand,Lohardaga,Exotic,1856,105,927,50,13,19,2970,5212,2427,8851,1468,417,74,18449,21419
Jharkhand,Lohardaga,Indigenous(Desi),12550,1080,45525,6659,2947,833,69594,14317,9367,22726,6165,1555,579,54709,124303
Jharkhand,Pakur,Exotic,2736,1622,1147,827,733,550,7615,2389,1984,1874,769,617,569,8202,15817
Jharkhand,Pakur,Indigenous(Desi),30268,12007,52515,25830,13301,6924,140845,55651,46980,56692,27919,30617,12896,230755,371600
Jharkhand,Palamu,Exotic,1098,315,291,88,98,24,1914,4281,2598,4712,2560,556,160,14867,16781
Jharkhand,Palamu,Indigenous(Desi),51897,9552,126067,5310,733,1421,194980,109990,104412,134422,89588,11195,5095,454702,649682
Jharkhand,Ramgarh,Exotic,1259,185,236,80,16,40,1816,3562,1674,5364,1497,287,34,12418,14234
Jharkhand,Ramgarh,Indigenous(Desi),8317,2781,41068,5171,510,1054,58901,11472,9876,14688,9352,1039,406,46833,105734
Jharkhand,Ranchi,Exotic,6047,1572,3220,723,565,553,12680,26156,20633,44444,9700,4754,2155,107842,120522
Jharkhand,Ranchi,Indigenous(Desi),48628,8672,176280,17052,3836,3226,257694,66626,61148,84416,32977,8910,4109,258186,515880
Jharkhand,Sahebganj,Exotic,1811,181,167,116,36,31,2342,4536,2518,6109,1801,691,145,15800,18142
Jharkhand,Sahebganj,Indigenous(Desi),30886,6029,28220,8213,1090,676,75114,43932,35112,51299,29444,8796,1344,169927,245041
Jharkhand,Saraikela Kharsawan,Exotic,318,85,100,30,21,21,575,1376,880,3017,630,137,65,6105,6680
Jharkhand,Saraikela Kharsawan,Indigenous(Desi),26571,4592,132473,4900,8549,1901,178986,31547,26076,35090,19478,5665,1650,119506,298492
Jharkhand,Simdega,Exotic,751,434,1092,451,234,255,3217,831,689,1392,460,317,212,3901,7118
Jharkhand,Simdega,Indigenous(Desi),42475,7901,153242,8753,1536,6187,220094,37792,37381,49469,33050,14848,3660,176200,396294
Jharkhand,West Singhbhum,Exotic,708,233,323,258,203,202,1927,1129,759,2015,425,149,102,4579,6506
Jharkhand,West Singhbhum,Indigenous(Desi),40835,9573,204139,27647,5850,8287,296331,38513,32759,48253,35847,8015,4778,168165,464496
Karnataka,Bagalkot,Exotic,756,76,146,38,10,13,1039,13965,10372,25139,10718,2317,287,62798,63837
Karnataka,Bagalkot,Indigenous(Desi),13372,825,45119,2950,410,244,62920,24034,15621,34331,18685,2994,401,96066,158986
Karnataka,Bangalore Rural,Exotic,472,186,331,42,35,6,1072,29600,24171,79149,15996,1779,214,150909,151981
Karnataka,Bangalore Rural,Indigenous(Desi),1836,233,2398,78,437,19,5001,2998,2972,5452,1969,318,31,13740,18741
Karnataka,Belgaum,Exotic,4036,166,1728,316,206,91,6543,50303,34857,115624,30460,5326,871,237441,243984
Karnataka,Belgaum,Indigenous(Desi),21595,1987,110718,2598,7815,416,145129,35238,25704,68500,23971,6113,901,160427,305556
Karnataka,Bellary,Exotic,1230,106,615,153,45,57,2206,11058,8169,23223,8674,786,205,52115,54321
Karnataka,Bellary,Indigenous(Desi),15208,2106,80941,2874,1607,311,103047,27450,24138,41951,29177,2994,621,126331,229378
Karnataka,Bengaluru Urban,Exotic,1902,773,532,219,298,137,3861,26096,23723,65882,11860,2732,882,131175,135036
Karnataka,Bengaluru Urban,Indigenous(Desi),1007,386,1337,240,164,113,3247,3120,2946,6363,2644,359,146,15578,18825
Karnataka,Bidar,Exotic,1165,99,379,22,7,5,1677,5375,1987,8300,2341,462,13,18478,20155
Karnataka,Bidar,Indigenous(Desi),12771,1120,44018,346,1903,122,60280,26041,11196,39801,13387,2506,268,93199,153479
Karnataka,Bijapur,Exotic,408,108,248,172,128,173,1237,3726,1877,6102,1285,162,77,13229,14466
Karnataka,Bijapur,Indigenous(Desi),12760,1451,53578,3825,2342,279,74235,31119,18731,47081,13979,1951,549,113410,187645
Karnataka,Chamarajanagar,Exotic,5292,173,1026,112,162,104,6869,40896,20999,76041,20091,4288,1021,163336,170205
Karnataka,Chamarajanagar,Indigenous(Desi),4998,689,16142,555,733,885,24002,12545,10761,17091,9681,3608,1468,55154,79156
Karnataka,Chikballapur,Exotic,222,141,325,137,57,16,898,28400,30158,87431,19552,3162,819,169522,170420
Karnataka,Chikballapur,Indigenous(Desi),2459,282,11946,427,814,95,16023,5380,5155,11349,4578,735,175,27372,43395
Karnataka,Chikmagalur,Exotic,3341,205,322,91,16,37,4012,24286,13778,53600,14518,2079,381,108642,112654
Karnataka,Chikmagalur,Indigenous(Desi),14724,2188,35606,914,485,461,54378,26837,24597,39823,26526,4399,793,122975,177353
Karnataka,Chitradurga,Exotic,1324,135,170,20,10,20,1679,15968,8406,33295,10841,1981,183,70674,72353
Karnataka,Chitradurga,Indigenous(Desi),11768,1438,49363,1506,1271,691,66037,16840,13362,29737,21848,4803,623,87213,153250
Karnataka,Dakshin Kannad,Exotic,7976,556,360,82,81,308,9363,46891,32806,73086,17513,2342,2156,174794,184157
Karnataka,Dakshin Kannad,Indigenous(Desi),3205,469,385,77,38,192,4366,16391,14172,22505,6550,1575,853,62046,66412
Karnataka,Davangere,Exotic,9356,165,426,126,35,119,10227,42220,23431,75842,22969,6289,713,171464,181691
Karnataka,Davangere,Indigenous(Desi),9112,914,49226,2008,1326,936,63522,11392,8930,20727,8726,2115,274,52164,115686
Karnataka,Dharwad,Exotic,3403,90,518,48,164,70,4293,17996,8986,33158,8278,2192,491,71101,75394
Karnataka,Dharwad,Indigenous(Desi),8039,523,48031,601,2513,217,59924,8716,6242,14682,5670,1378,213,36901,96825
Karnataka,Gadag,Exotic,1524,389,935,1631,38,113,4630,14403,9318,20417,5953,1875,535,52501,57131
Karnataka,Gadag,Indigenous(Desi),3694,822,37410,492,772,552,43742,9842,5376,12791,5338,1532,559,35438,79180
Karnataka,Gulbarga,Exotic,926,68,244,35,10,1,1284,3665,1740,5764,1865,180,15,13229,14513
Karnataka,Gulbarga,Indigenous(Desi),31696,4458,119248,3312,2882,586,162182,54055,38466,72977,35341,6567,1479,208885,371067
Karnataka,Hassan,Exotic,6288,428,5441,100,283,24,12564,72242,42769,176296,45738,5824,812,343681,356245
Karnataka,Hassan,Indigenous(Desi),13344,1015,50091,804,3339,149,68742,23037,19650,47294,24823,7407,987,123198,191940
Karnataka,Haveri,Exotic,2598,84,335,17,3,10,3047,26097,12577,44504,11496,3028,284,97986,101033
Karnataka,Haveri,Indigenous(Desi),11279,618,102223,445,358,386,115309,11202,7899,17292,6418,1744,163,44718,160027
Karnataka,Kodagu,Exotic,3969,507,790,365,71,151,5853,8508,6545,13704,4051,835,270,33913,39766
Karnataka,Kodagu,Indigenous(Desi),3803,548,4475,320,25,425,9596,5412,3976,7904,4249,512,269,22322,31918
Karnataka,Kolar,Exotic,222,36,267,60,21,8,614,30950,33485,99051,19768,1562,353,185169,185783
Karnataka,Kolar,Indigenous(Desi),2019,110,6869,209,492,139,9838,2061,3189,5672,2395,655,49,14021,23859
Karnataka,Koppal,Exotic,1483,69,338,83,24,103,2100,13001,8981,22026,7080,1532,212,52832,54932
Karnataka,Koppal,Indigenous(Desi),13125,1944,45507,5234,2241,275,68326,24702,18196,40438,18674,4693,1452,108155,176481
Karnataka,Mandya,Exotic,1015,70,2101,46,257,112,3601,55863,39840,156053,34411,3406,731,290304,293905
Karnataka,Mandya,Indigenous(Desi),3549,201,20382,505,2167,260,27064,3506,9348,5492,5354,22449,2868,49017,76081
Karnataka,Mysore,Exotic,6130,411,4807,429,243,249,12269,74865,39188,149569,34090,5494,1586,304792,317061
Karnataka,Mysore,Indigenous(Desi),11242,1537,39604,1157,3721,540,57801,19931,18920,37116,26464,13922,1383,117736,175537
Karnataka,Raichur,Exotic,262,39,103,8,20,36,468,3999,2334,7308,3962,375,98,18076,18544
Karnataka,Raichur,Indigenous(Desi),21209,1909,63892,1939,2177,275,91401,32518,31502,38746,28509,3696,458,135429,226830
Karnataka,Ramanagara,Exotic,654,89,973,37,466,12,2231,46083,26730,100626,28490,2048,798,204775,207006
Karnataka,Ramanagara,Indigenous(Desi),5063,258,3627,339,328,76,9691,15789,11130,27346,12283,3112,1145,70805,80496
Karnataka,Shimoga,Exotic,8019,296,417,36,12,212,8992,28535,19454,56691,18582,5287,472,129021,138013
Karnataka,Shimoga,Indigenous(Desi),44716,11195,49344,1315,1512,9305,117387,46936,54140,70230,62470,24300,5177,263253,380640
Karnataka,Tumkur,Exotic,877,133,324,42,30,20,1426,46975,43551,135303,37710,5113,1390,270042,271468
Karnataka,Tumkur,Indigenous(Desi),10461,741,16808,704,346,198,29258,24056,26357,43702,27598,8018,794,130525,159783
Karnataka,Udupi,Exotic,5015,233,234,54,104,308,5948,31185,23401,57482,17172,2350,481,132071,138019
Karnataka,Udupi,Indigenous(Desi),7625,673,1172,152,24,461,10107,27125,22399,39188,14889,2529,520,106650,116757
Karnataka,Uttar Kannad,Exotic,4351,88,398,186,10,96,5129,12546,9743,24434,7144,3118,401,57386,62515
Karnataka,Uttar Kannad,Indigenous(Desi),32648,3168,53004,5114,1681,2320,97935,36010,39579,54564,35233,9320,1156,175862,273797
Karnataka,Yadgir,Exotic,113,46,227,52,43,33,514,303,166,347,166,62,16,1060,1574
Karnataka,Yadgir,Indigenous(Desi),21702,1346,58906,1740,6586,1001,91281,34128,25792,43971,28764,6423,1403,140481,231762
Kerala,Alappuzha,Exotic,4890,77,52,10,26,210,5265,17290,13400,35022,4991,595,319,71617,76882
Kerala,Alappuzha,Indigenous(Desi),268,10,0,1,0,12,291,539,578,808,219,25,28,2197,2488
Kerala,Ernakulam,Exotic,6027,68,28,48,60,278,6509,23290,18319,45798,7811,765,486,96469,102978
Kerala,Ernakulam,Indigenous(Desi),656,43,4,4,1,42,750,1158,941,1635,526,42,31,4333,5083
Kerala,Idukki,Exotic,5678,324,181,119,104,231,6637,22092,14264,38934,8484,897,671,85342,91979
Kerala,Idukki,Indigenous(Desi),570,42,227,34,10,16,899,1269,936,1731,474,72,35,4517,5416
Kerala,Kannur,Exotic,8706,107,71,27,73,175,9159,19858,15656,35753,6511,798,311,78887,88046
Kerala,Kannur,Indigenous(Desi),414,14,20,1,0,20,469,898,660,1223,322,46,23,3172,3641
Kerala,Kasaragod,Exotic,4651,98,105,96,37,153,5140,12163,9530,19655,5014,588,518,47468,52608
Kerala,Kasaragod,Indigenous(Desi),2537,80,202,97,27,144,3087,4134,4847,5893,2673,405,321,18273,21360
Kerala,Kollam,Exotic,8391,138,98,31,64,232,8954,25855,15870,48561,7500,587,512,98885,107839
Kerala,Kollam,Indigenous(Desi),390,15,1,0,0,8,414,625,501,920,207,12,24,2289,2703
Kerala,Kottayam,Exotic,5324,105,79,41,76,120,5745,17017,14935,33353,5651,671,261,71888,77633
Kerala,Kottayam,Indigenous(Desi),419,19,2,8,4,18,470,732,710,1076,394,42,17,2971,3441
Kerala,Kozhikode,Exotic,8181,150,107,85,96,149,8768,21095,15186,35398,6610,749,407,79445,88213
Kerala,Kozhikode,Indigenous(Desi),492,11,71,2,35,53,664,1639,1162,1928,546,68,28,5371,6035
Kerala,Malappuram,Exotic,9868,103,152,113,60,805,11101,18960,11335,34821,6430,697,477,72720,83821
Kerala,Malappuram,Indigenous(Desi),989,21,80,10,20,296,1416,453,325,689,299,14,18,1798,3214
Kerala,Palakkad,Exotic,15457,330,305,196,168,555,17011,33518,22450,61496,14188,2933,1762,136347,153358
Kerala,Palakkad,Indigenous(Desi),1651,154,194,103,272,166,2540,2775,2321,3496,1486,752,224,11054,13594
Kerala,Pathanamthitta,Exotic,4690,43,100,29,33,176,5071,13358,9969,24602,3892,492,240,52553,57624
Kerala,Pathanamthitta,Indigenous(Desi),319,15,4,0,0,11,349,932,781,1268,175,13,15,3184,3533
Kerala,Thiruvananthapuram,Exotic,6042,65,54,43,49,118,6371,20798,12873,49138,6131,694,450,90084,96455
Kerala,Thiruvananthapuram,Indigenous(Desi),227,17,1,2,4,16,267,540,386,1032,121,15,6,2100,2367
Kerala,Thrissur,Exotic,7724,65,94,71,49,255,8258,23357,20003,45630,6708,491,375,96564,104822
Kerala,Thrissur,Indigenous(Desi),920,52,1,1,14,69,1057,1468,1502,2385,641,35,22,6053,7110
Kerala,Wayanad,Exotic,5787,51,38,39,46,128,6089,17528,14820,29481,8191,615,322,70957,77046
Kerala,Wayanad,Indigenous(Desi),348,35,35,14,2,33,467,542,604,702,374,12,6,2240,2707
Lakshadweep,Lakshadweep District,Exotic,99,34,37,18,2,45,235,238,234,310,126,40,13,961,1196
Lakshadweep,Lakshadweep District,Indigenous(Desi),301,29,36,11,1,172,550,171,230,212,92,22,20,747,1297
Madhya Pradesh,AGAR MALWA,Exotic,77,14,17,12,1,0,121,226,102,379,101,7,4,819,940
Madhya Pradesh,AGAR MALWA,Indigenous(Desi),9843,1810,7657,1192,604,548,21654,35170,18636,51566,26031,3576,1535,136514,158168
Madhya Pradesh,ALIRAJPUR,Exotic,21,0,20,4,0,0,45,49,29,84,63,3,0,228,273
Madhya Pradesh,ALIRAJPUR,Indigenous(Desi),21619,3023,188660,10721,562,274,224859,32356,29818,35618,34223,2158,2710,136883,361742
Madhya Pradesh,ANUPPUR,Exotic,2356,229,5354,315,23,53,8330,4902,2715,6823,3741,1098,186,19465,27795
Madhya Pradesh,ANUPPUR,Indigenous(Desi),30383,3514,173329,4418,392,440,212476,30852,22649,42760,34326,8686,1069,140342,352818
Madhya Pradesh,ASHOKNAGAR,Exotic,735,45,23,10,10,21,844,2212,1423,2513,1097,242,77,7564,8408
Madhya Pradesh,ASHOKNAGAR,Indigenous(Desi),16443,2551,3094,186,1295,740,24309,52720,29773,75290,37455,5208,1152,201598,225907
Madhya Pradesh,BALAGHAT,Exotic,2022,155,1321,240,156,121,4015,4383,3099,5657,3299,856,247,17541,21556
Madhya Pradesh,BALAGHAT,Indigenous(Desi),49797,4576,224159,10558,18205,2210,309505,59533,53975,68831,77358,12487,2683,274867,584372
Madhya Pradesh,BARWANI,Exotic,90,15,82,16,9,1,213,181,119,267,164,40,14,785,998
Madhya Pradesh,BARWANI,Indigenous(Desi),29578,4610,183329,3910,4613,1677,227717,40912,34004,56770,52274,5106,2351,191417,419134
Madhya Pradesh,BETUL,Exotic,4379,902,2841,566,252,229,9169,17783,11961,23643,6447,1194,588,61616,70785
Madhya Pradesh,BETUL,Indigenous(Desi),33541,5940,217321,5219,2732,3205,267958,53044,47058,76939,44678,8892,3851,234462,502420
Madhya Pradesh,BHIND,Exotic,1495,18,29,1,1,16,1560,7559,3996,11209,3314,272,118,26468,28028
Madhya Pradesh,BHIND,Indigenous(Desi),4752,248,1059,30,193,257,6539,23550,11929,39300,14067,1945,768,91559,98098
Madhya Pradesh,BHOPAL,Exotic,3505,295,135,39,9,44,4027,11611,4930,18359,5504,1469,166,42039,46066
Madhya Pradesh,BHOPAL,Indigenous(Desi),5892,827,1428,108,273,173,8701,17332,9558,28992,11359,1947,610,69798,78499
Madhya Pradesh,BURHANPUR,Exotic,142,54,486,32,27,41,782,514,398,790,564,126,24,2416,3198
Madhya Pradesh,BURHANPUR,Indigenous(Desi),9910,2839,46111,2977,831,516,63184,15418,13088,23566,15040,3459,881,71452,134636
Madhya Pradesh,CHHATARPUR,Exotic,599,95,151,51,20,19,935,2624,1757,3526,907,434,162,9410,10345
Madhya Pradesh,CHHATARPUR,Indigenous(Desi),21403,4007,36807,4424,1330,1054,69025,61370,30710,78879,39784,11161,2390,224294,293319
Madhya Pradesh,CHHINDWARA,Exotic,4164,537,2341,283,327,83,7735,12179,10054,17053,9129,1194,560,50169,57904
Madhya Pradesh,CHHINDWARA,Indigenous(Desi),59898,9588,229192,15445,6710,1541,322374,77756,63252,96676,79237,11329,3629,331879,654253
Madhya Pradesh,DAMOH,Exotic,690,73,73,8,6,10,860,2339,1471,2751,1227,265,77,8130,8990
Madhya Pradesh,DAMOH,Indigenous(Desi),29573,6603,33632,3131,1667,823,75429,91990,69260,125790,87916,13629,7102,395687,471116
Madhya Pradesh,DATIA,Exotic,64,13,21,4,2,1,105,4091,1381,4878,1475,267,430,12522,12627
Madhya Pradesh,DATIA,Indigenous(Desi),2296,427,5366,536,197,149,8971,24892,14764,31891,15704,2690,2690,92631,101602
Madhya Pradesh,DEWAS,Exotic,3111,620,412,24,22,37,4226,13778,6508,23951,6144,972,175,51528,55754
Madhya Pradesh,DEWAS,Indigenous(Desi),30208,5358,42918,2267,869,606,82226,61185,45606,97718,37815,5262,1567,249153,331379
Madhya Pradesh,DHAR,Exotic,9318,153,237,68,17,64,9857,15865,9863,22642,10313,1331,716,60730,70587
Madhya Pradesh,DHAR,Indigenous(Desi),44052,2514,193579,6342,4293,1513,252293,80147,64483,109802,73426,8915,3884,340657,592950
Madhya Pradesh,DINDORI,Exotic,231,129,329,106,37,46,878,376,401,430,257,55,61,1580,2458
Madhya Pradesh,DINDORI,Indigenous(Desi),30359,12352,222676,12715,1586,3850,283538,35976,38830,41584,37705,5711,2267,162073,445611
Madhya Pradesh,EAST NIMAR,Exotic,233,26,1175,4,5,106,1549,502,473,671,290,69,96,2101,3650
Madhya Pradesh,EAST NIMAR,Indigenous(Desi),34398,3364,120958,2737,1093,1640,164190,45545,38812,60684,45077,4457,11412,205987,370177
Madhya Pradesh,GUNA,Exotic,1417,496,608,60,24,10,2615,4094,2558,5494,1243,193,89,13671,16286
Madhya Pradesh,GUNA,Indigenous(Desi),27972,5676,26984,2229,5892,2425,71178,74107,50666,105335,46298,6363,4505,287274,358452
Madhya Pradesh,GWALIOR,Exotic,856,65,8,13,9,1,952,3446,1254,6246,1187,190,165,12488,13440
Madhya Pradesh,GWALIOR,Indigenous(Desi),11119,2223,2142,217,510,102,16313,29178,17208,47323,19407,2588,1187,116891,133204
Madhya Pradesh,HARDA,Exotic,1051,50,29,4,0,3,1137,2182,2014,3476,1596,184,47,9499,10636
Madhya Pradesh,HARDA,Indigenous(Desi),14639,2059,20471,2255,357,201,39982,24770,21021,31220,27702,3070,1086,108869,148851
Madhya Pradesh,HOSHANGABAD,Exotic,2068,187,168,83,22,28,2556,10017,7304,13176,5030,886,226,36639,39195
Madhya Pradesh,HOSHANGABAD,Indigenous(Desi),19147,2038,14672,1256,568,585,38266,64362,47619,79414,49027,7202,5267,252891,291157
Madhya Pradesh,INDORE,Exotic,7021,938,1190,269,89,107,9614,36481,22033,73088,17020,5007,606,154235,163849
Madhya Pradesh,INDORE,Indigenous(Desi),5602,941,4766,289,5927,85,17610,14606,6617,27295,8119,1364,414,58415,76025
Madhya Pradesh,JABALPUR,Exotic,2226,244,284,44,7,89,2894,13296,8085,17819,6393,2242,257,48092,50986
Madhya Pradesh,JABALPUR,Indigenous(Desi),21285,4060,41248,1092,840,680,69205,40596,30591,55666,37824,7680,2273,174630,243835
Madhya Pradesh,JHABUA,Exotic,2758,245,3865,50,39,14,6971,8539,5323,10938,5331,725,147,31003,37974
Madhya Pradesh,JHABUA,Indigenous(Desi),29052,2127,174420,3271,614,425,209909,44743,30384,58110,44151,4877,692,182957,392866
Madhya Pradesh,KATNI,Exotic,439,148,148,64,38,73,910,1050,712,1577,1046,376,249,5010,5920
Madhya Pradesh,KATNI,Indigenous(Desi),38310,9456,61830,5407,9963,3133,128099,59452,46195,72475,54638,10778,3847,247385,375484
Madhya Pradesh,KHARGONE,Exotic,128,28,230,7,1,12,406,463,413,1205,445,128,42,2696,3102
Madhya Pradesh,KHARGONE,Indigenous(Desi),63610,10717,200265,9129,13983,2010,299714,65722,55539,103077,72063,10244,3462,310107,609821
Madhya Pradesh,MANDLA,Exotic,1712,197,1273,263,170,105,3720,2707,2014,3703,1806,373,104,10707,14427
Madhya Pradesh,MANDLA,Indigenous(Desi),34655,7791,211420,20472,880,2029,277247,40603,38861,48556,55395,8641,2470,194526,471773
Madhya Pradesh,MORENA,Exotic,1918,195,45,10,13,94,2275,8132,4152,12957,2754,302,49,28346,30621
Madhya Pradesh,MORENA,Indigenous(Desi),5492,322,2167,110,278,490,8859,17637,10548,29108,9978,1477,320,69068,77927
Madhya Pradesh,Mandsaur,Exotic,5288,543,100,25,20,45,6021,17042,9774,24247,11168,1228,526,63985,70006
Madhya Pradesh,Mandsaur,Indigenous(Desi),10282,1427,14320,519,686,886,28120,47437,22079,57752,30255,4614,3688,165825,193945
Madhya Pradesh,NARSINGHPUR,Exotic,3535,147,499,56,95,107,4439,7835,4479,10456,5402,946,147,29265,33704
Madhya Pradesh,NARSINGHPUR,Indigenous(Desi),16751,2927,20070,726,1738,528,42740,45386,33813,57222,37919,3708,412,178460,221200
Madhya Pradesh,NEEMUCH,Exotic,3871,224,192,65,2,113,4467,10048,6852,14740,5477,1218,111,38446,42913
Madhya Pradesh,NEEMUCH,Indigenous(Desi),16385,2087,14708,1759,139,476,35554,38535,28481,55289,32899,2810,866,158880,194434
Madhya Pradesh,PANNA,Exotic,707,62,35,18,36,63,921,903,483,929,280,94,11,2700,3621
Madhya Pradesh,PANNA,Indigenous(Desi),22183,6699,59552,11006,3674,1517,104631,66284,44079,82548,55890,5517,2945,257263,361894
Madhya Pradesh,RAISEN,Exotic,2085,345,352,161,52,67,3062,28611,24400,36848,23942,2657,1589,118047,121109
Madhya Pradesh,RAISEN,Indigenous(Desi),32782,5544,17563,3114,2051,1197,62251,69439,50465,87214,57858,4469,1624,271069,333320
Madhya Pradesh,RAJGARH,Exotic,909,137,88,27,3,13,1177,5108,2283,7073,1704,191,94,16453,17630
Madhya Pradesh,RAJGARH,Indigenous(Desi),13163,1612,19941,2109,4274,205,41304,62954,30416,82294,30856,3631,2668,212819,254123
Madhya Pradesh,RATLAM,Exotic,5078,227,711,285,31,155,6487,12879,7272,19606,8657,1176,364,49954,56441
Madhya Pradesh,RATLAM,Indigenous(Desi),24888,2088,47438,6648,2503,1325,84890,39084,28401,61820,42674,4009,2429,178417,263307
Madhya Pradesh,REWA,Exotic,4135,241,347,100,84,113,5020,15510,13165,20642,10723,2462,914,63416,68436
Madhya Pradesh,REWA,Indigenous(Desi),38207,4769,51719,3526,2070,2302,102593,114394,102592,142160,106843,18202,7549,491740,594333
Madhya Pradesh,SAGAR,Exotic,3293,353,325,151,61,82,4265,7031,4267,8791,3400,678,203,24370,28635
Madhya Pradesh,SAGAR,Indigenous(Desi),61871,13906,24696,2704,3269,4373,110819,137697,103545,192913,143387,20568,7411,605521,716340
Madhya Pradesh,SATNA,Exotic,2439,737,416,68,38,166,3864,10325,5858,12177,6545,1104,480,36489,40353
Madhya Pradesh,SATNA,Indigenous(Desi),33121,4966,40435,7371,1449,2283,89625,105840,79984,144881,93927,14441,10858,449931,539556
Madhya Pradesh,SEHORE,Exotic,4499,494,1917,219,72,198,7399,37357,19870,56295,13142,2684,666,130014,137413
Madhya Pradesh,SEHORE,Indigenous(Desi),12249,1174,19018,1185,1966,647,36239,54620,31379,76970,27267,3671,981,194888,231127
Madhya Pradesh,SEONI,Exotic,4076,248,1038,148,177,128,5815,9146,6802,11560,5608,1420,284,34820,40635
Madhya Pradesh,SEONI,Indigenous(Desi),40651,3165,127303,7114,28420,1402,208055,46534,36594,60320,43895,7495,2084,196922,404977
Madhya Pradesh,SHAHDOL,Exotic,1180,115,189,88,9,19,1600,3918,2738,4732,2311,472,79,14250,15850
Madhya Pradesh,SHAHDOL,Indigenous(Desi),40571,10186,201060,14434,5616,3555,275422,50046,49157,66650,49413,11214,6784,233264,508686
Madhya Pradesh,SHAJAPUR,Exotic,2082,227,306,316,76,21,3028,8453,7531,18829,2654,1194,292,38953,41981
Madhya Pradesh,SHAJAPUR,Indigenous(Desi),8988,693,7213,275,280,143,17592,28294,14590,47496,10537,2231,575,103723,121315
Madhya Pradesh,SHEOPUR,Exotic,145,111,9,39,247,16,567,915,451,1063,475,113,224,3241,3808
Madhya Pradesh,SHEOPUR,Indigenous(Desi),19946,6120,14223,3323,3019,349,46980,47795,40962,65261,42034,15926,1347,213325,260305
Madhya Pradesh,SHIVPURI,Exotic,486,35,33,47,4,23,628,2476,1019,2853,965,79,21,7413,8041
Madhya Pradesh,SHIVPURI,Indigenous(Desi),22574,5903,49581,1748,2413,2887,85106,71485,43873,97833,54745,4821,4002,276759,361865
Madhya Pradesh,SIDHI,Exotic,3224,127,531,46,4,131,4063,9254,5691,11605,5081,1480,503,33614,37677
Madhya Pradesh,SIDHI,Indigenous(Desi),43908,4573,156312,15988,690,3436,224907,50718,50869,76215,65219,9820,4588,257429,482336
Madhya Pradesh,SINGRAULI,Exotic,334,54,288,51,13,17,757,1548,799,2123,663,57,56,5246,6003
Madhya Pradesh,SINGRAULI,Indigenous(Desi),48484,8118,197557,22229,6291,5353,288032,63787,48187,75791,57398,7251,2653,255067,543099
Madhya Pradesh,TIKAMGARH,Exotic,502,151,165,31,32,51,932,4413,2668,5046,2124,521,227,14999,15931
Madhya Pradesh,TIKAMGARH,Indigenous(Desi),13136,3347,37294,2890,2200,1412,60279,63875,33966,77908,42170,9842,3235,230996,291275
Madhya Pradesh,UJJAIN,Exotic,3548,346,387,142,94,66,4583,19965,9835,29097,9898,1253,464,70512,75095
Madhya Pradesh,UJJAIN,Indigenous(Desi),9821,1604,4040,894,667,172,17198,45865,26196,66455,26978,4967,2767,173228,190426
Madhya Pradesh,UMARIA,Exotic,275,15,81,10,3,1,385,1154,448,1478,765,44,1,3890,4275
Madhya Pradesh,UMARIA,Indigenous(Desi),32354,4140,120085,2667,151,479,159876,40368,28517,47787,47367,2008,409,166456,326332
Madhya Pradesh,VIDISHA,Exotic,533,26,139,3,9,26,736,1882,1048,2751,1979,150,74,7884,8620
Madhya Pradesh,VIDISHA,Indigenous(Desi),24498,3190,8291,860,251,972,38062,65362,35484,92072,66455,5861,2766,268000,306062
Maharashtra,Ahmednagar,Exotic,7118,620,2888,764,461,171,12022,158266,162071,467751,155090,12859,5744,961781,973803
Maharashtra,Ahmednagar,Indigenous(Desi),31102,2565,101288,7094,18081,578,160708,43313,38303,96513,61057,3029,1577,243792,404500
Maharashtra,Akola,Exotic,852,120,705,89,116,47,1929,2116,1484,3612,1840,207,103,9362,11291
Maharashtra,Akola,Indigenous(Desi),25563,3550,55703,1853,9304,758,96731,28948,21562,45180,26611,1944,1004,125249,221980
Maharashtra,Amravati,Exotic,2132,273,815,61,526,67,3874,7377,5665,12572,5268,474,344,31700,35574
Maharashtra,Amravati,Indigenous(Desi),38641,6206,80753,3303,45396,1988,176287,56398,47771,90334,51837,3474,3292,253106,429393
Maharashtra,Aurangabad,Exotic,5940,959,8649,675,400,252,16875,42473,22179,75143,28549,4234,2861,175439,192314
Maharashtra,Aurangabad,Indigenous(Desi),20321,2954,168895,5675,7052,972,205869,30609,20395,55962,28864,2941,1618,140389,346258
Maharashtra,Beed,Exotic,3343,844,4218,669,350,112,9536,25202,18734,51859,22124,3919,822,122660,132196
Maharashtra,Beed,Indigenous(Desi),23927,3473,161710,7743,26425,845,224123,35171,21884,51584,27410,3108,892,140049,364172
Maharashtra,Bhandara,Exotic,7240,322,1691,113,537,73,9976,26414,22177,35223,22438,2276,1522,110050,120026
Maharashtra,Bhandara,Indigenous(Desi),7464,449,31309,260,6746,145,46373,10911,9996,13306,10854,1072,498,46637,93010
Maharashtra,Buldhana,Exotic,2250,458,3833,1363,849,79,8832,9419,6602,20408,7597,735,315,45076,53908
Maharashtra,Buldhana,Indigenous(Desi),36045,5425,116338,5450,35985,1215,200458,41783,35179,74456,46522,5220,4003,207163,407621
Maharashtra,Chandrapur,Exotic,2263,359,1262,93,175,119,4271,6651,4449,8816,4984,616,207,25723,29994
Maharashtra,Chandrapur,Indigenous(Desi),44409,3504,142288,1858,26470,1171,219700,38187,23817,46771,33899,2593,953,146220,365920
Maharashtra,Dhule,Exotic,3485,378,3081,341,56,39,7380,12799,9322,27075,6733,1850,365,58144,65524
Maharashtra,Dhule,Indigenous(Desi),16748,2766,137394,3045,12288,1393,173634,22334,20867,47320,20924,3257,684,115386,289020
Maharashtra,Gadchiroli,Exotic,1849,67,538,9,213,36,2712,1632,1789,2322,1626,292,29,7690,10402
Maharashtra,Gadchiroli,Indigenous(Desi),50182,5631,131990,5465,58538,2193,253999,38431,39165,51305,58899,5656,1614,195070,449069
Maharashtra,Gondia,Exotic,2628,108,860,154,120,55,3925,7192,5644,11063,5263,1379,209,30750,34675
Maharashtra,Gondia,Indigenous(Desi),21907,1826,89640,3250,11669,1121,129413,28821,26701,38658,28999,4350,1010,128539,257952
Maharashtra,Hingoli,Exotic,1048,110,1035,80,27,11,2311,3499,2096,4860,1627,118,97,12297,14608
Maharashtra,Hingoli,Indigenous(Desi),17413,2538,84427,6953,6757,737,118825,23673,17441,39785,15733,1417,721,98770,217595
Maharashtra,Jalgaon,Exotic,3441,697,8682,408,658,234,14120,34030,22592,61525,18212,2722,1250,140331,154451
Maharashtra,Jalgaon,Indigenous(Desi),24947,6219,170853,5758,27821,1961,237559,38237,31389,78208,31452,4333,1673,185292,422851
Maharashtra,Jalna,Exotic,1989,1316,2944,586,166,69,7070,12379,6401,21626,7177,741,164,48488,55558
Maharashtra,Jalna,Indigenous(Desi),27402,4430,160038,3532,24154,945,220501,34359,22334,61451,23649,3053,1070,145916,366417
Maharashtra,Kolhapur,Exotic,480,93,1113,164,77,20,1947,26559,35534,122764,19732,2470,549,207608,209555
Maharashtra,Kolhapur,Indigenous(Desi),3105,546,31213,983,1531,136,37514,5079,7152,19869,3812,502,154,36568,74082
Maharashtra,Latur,Exotic,1828,141,1139,115,23,11,3257,5551,3102,10366,3821,297,180,23317,26574
Maharashtra,Latur,Indigenous(Desi),18546,1987,81638,5052,2441,505,110169,29037,18477,48596,21804,2000,851,120765,230934
Maharashtra,Mumbai,Exotic,31,42,25,26,25,65,214,154,156,657,128,20,13,1128,1342
Maharashtra,Mumbai,Indigenous(Desi),124,68,53,56,38,55,394,169,214,881,137,71,18,1490,1884
Maharashtra,Nagpur,Exotic,8434,772,3273,247,536,208,13470,25328,15347,41276,19394,3330,1165,105840,119310
Maharashtra,Nagpur,Indigenous(Desi),25053,4037,97537,2541,17441,1385,147994,33732,24200,53640,33618,4096,1958,151244,299238
Maharashtra,Nanded,Exotic,973,83,326,42,22,2,1448,3973,1906,6816,1697,264,79,14735,16183
Maharashtra,Nanded,Indigenous(Desi),41148,6169,157059,8718,6026,1342,220462,64625,40892,99561,48459,9243,3003,265783,486245
Maharashtra,Nandurbar,Exotic,1023,47,1095,25,78,21,2289,3603,2533,5935,2760,508,89,15428,17717
Maharashtra,Nandurbar,Indigenous(Desi),16915,1352,91202,16566,47883,603,174521,24004,20448,36054,26685,4003,873,112067,286588
Maharashtra,Nashik,Exotic,9771,974,9997,971,640,145,22498,70601,47505,152812,41993,7471,2444,322826,345324
Maharashtra,Nashik,Indigenous(Desi),31038,3293,206603,10628,29265,1524,282351,55898,37762,101771,60306,7348,4290,267375,549726
Maharashtra,Osmanabad,Exotic,4885,411,5677,459,159,90,11681,41104,29679,96808,26260,4749,1183,199783,211464
Maharashtra,Osmanabad,Indigenous(Desi),10023,1352,68368,4064,3195,333,87335,15767,10956,27128,7753,1618,401,63623,150958
Maharashtra,Palghar,Exotic,713,306,193,178,63,50,1503,1234,1013,3028,846,216,245,6582,8085
Maharashtra,Palghar,Indigenous(Desi),18964,8420,104532,8147,5414,1084,146561,15621,14492,26479,23705,2337,1124,83758,230319
Maharashtra,Parbhani,Exotic,482,73,398,43,22,7,1025,1976,819,3475,1072,112,19,7473,8498
Maharashtra,Parbhani,Indigenous(Desi),20564,4555,128042,3405,4186,934,161686,34981,18972,50589,21272,2652,1211,129677,291363
Maharashtra,Pune,Exotic,3671,693,3232,702,225,106,8629,103570,103315,322955,84477,12835,3508,630660,639289
Maharashtra,Pune,Indigenous(Desi),13212,1882,59329,5036,4699,1010,85168,21618,20691,55530,20455,2857,1137,122288,207456
Maharashtra,Raigad,Exotic,997,86,1390,257,174,167,3071,2813,1989,6760,2075,300,122,14059,17130
Maharashtra,Raigad,Indigenous(Desi),14539,1224,47954,4456,7992,842,77007,19846,12621,36548,11152,1874,728,82769,159776
Maharashtra,Ratnagiri,Exotic,2256,142,3756,936,21,128,7239,4492,3192,8224,3168,698,218,19992,27231
Maharashtra,Ratnagiri,Indigenous(Desi),20469,1686,92621,5390,672,2112,122950,18206,13226,29773,19199,3153,1322,84879,207829
Maharashtra,Sangli,Exotic,727,143,609,112,65,9,1665,34228,34944,122824,27338,2120,734,222188,223853
Maharashtra,Sangli,Indigenous(Desi),5690,1070,21076,1340,1693,216,31085,11919,12225,32194,12050,826,604,69818,100903
Maharashtra,Satara,Exotic,1154,111,645,84,61,65,2120,44236,41368,123151,30784,5845,1277,246661,248781
Maharashtra,Satara,Indigenous(Desi),5827,643,27749,1636,2306,388,38549,11816,11265,27490,12687,1171,677,65106,103655
Maharashtra,Sindhudurg,Exotic,1400,27,858,105,8,46,2444,2649,1851,4199,1559,336,72,10666,13110
Maharashtra,Sindhudurg,Indigenous(Desi),9406,1239,39561,2693,524,1040,54463,8629,6867,13792,7632,963,464,38347,92810
Maharashtra,Solapur,Exotic,3122,723,1657,553,178,132,6365,91505,85411,252795,63470,9379,3062,505622,511987
Maharashtra,Solapur,Indigenous(Desi),11030,2591,46664,3267,2262,423,66237,36183,27031,74890,25848,2196,1032,167180,233417
Maharashtra,Thane,Exotic,209,85,43,55,36,25,453,802,568,2104,575,134,74,4257,4710
Maharashtra,Thane,Indigenous(Desi),5727,1489,17035,5789,2103,395,32538,7602,7100,16801,7806,1569,1396,42274,74812
Maharashtra,Wardha,Exotic,3551,548,2643,503,141,139,7525,10123,7001,17301,6962,1135,644,43166,50691
Maharashtra,Wardha,Indigenous(Desi),19974,2113,74001,3872,5223,357,105540,29044,18169,40759,28448,2061,1168,119649,225189
Maharashtra,Washim,Exotic,232,45,1046,23,39,17,1402,847,726,1576,633,53,34,3869,5271
Maharashtra,Washim,Indigenous(Desi),13912,1666,37409,3893,10091,616,67587,17027,15780,34763,25860,1172,631,95233,162820
Maharashtra,Yavatmal,Exotic,1223,138,424,18,12,18,1833,3383,2237,6190,3085,369,204,15468,17301
Maharashtra,Yavatmal,Indigenous(Desi),56923,5710,177851,5518,9152,1497,256651,66869,61487,102275,81827,6636,3067,322161,578812
Manipur,Bishnupur,Exotic,170,51,14,59,54,1,349,2433,2515,2862,131,506,31,8478,8827
Manipur,Bishnupur,Indigenous(Desi),1830,413,1640,451,878,187,5399,7781,6923,7785,1952,1226,335,26002,31401
Manipur,Chandel,Exotic,4,0,5,0,1,0,10,0,3,1,0,2,2,8,18
Manipur,Chandel,Indigenous(Desi),1845,180,2203,728,100,1059,6115,1743,2083,969,475,1213,2227,8710,14825
Manipur,Churachandpur,Exotic,38,34,7,10,1,45,135,65,39,72,39,30,30,275,410
Manipur,Churachandpur,Indigenous(Desi),3105,1817,1243,724,643,713,8245,3522,4260,3874,1119,1383,667,14825,23070
Manipur,Imphal East,Exotic,116,34,15,6,0,26,197,633,235,694,147,235,15,1959,2156
Manipur,Imphal East,Indigenous(Desi),6432,483,3355,657,483,316,11726,8143,5134,8487,2284,2241,473,26762,38488
Manipur,Imphal West,Exotic,284,24,2,2,4,7,323,981,360,1446,318,131,61,3297,3620
Manipur,Imphal West,Indigenous(Desi),2801,73,2083,89,696,912,6654,4137,3909,4757,1751,1043,646,16243,22897
Manipur,Senapati,Exotic,47,30,12,5,10,2,106,253,287,267,155,93,26,1081,1187
Manipur,Senapati,Indigenous(Desi),2866,1068,3505,4215,349,1187,13190,4202,3562,4522,2345,1642,1178,17451,30641
Manipur,Tamenglong,Exotic,1,0,0,0,0,0,1,1,1,1,0,0,0,3,4
Manipur,Tamenglong,Indigenous(Desi),1131,181,212,303,35,1833,3695,1544,1358,1453,416,483,1187,6441,10136
Manipur,Thoubal,Exotic,61,40,2,4,0,1,108,396,201,821,112,22,0,1552,1660
Manipur,Thoubal,Indigenous(Desi),2277,746,1107,314,125,95,4664,6125,5269,5361,1474,1275,154,19658,24322
Manipur,Ukhrul,Exotic,3,10,0,0,0,0,13,8,1,13,3,6,0,31,44
Manipur,Ukhrul,Indigenous(Desi),3824,819,409,473,205,329,6059,1041,1660,798,533,491,184,4707,10766
Meghalaya,East Garo Hills,Exotic,25,5,0,6,0,3,39,10,3,20,2,2,0,37,76
Meghalaya,East Garo Hills,Indigenous(Desi),11231,1945,590,16424,669,1815,32674,10581,8033,13001,6838,5205,864,44522,77196
Meghalaya,East Jaintia Hills,Exotic,117,13,0,126,0,113,369,70,86,92,104,81,163,596,965
Meghalaya,East Jaintia Hills,Indigenous(Desi),10336,1336,187,5473,390,3475,21197,7667,9543,5977,4897,3696,1672,33452,54649
Meghalaya,East Khasi Hills,Exotic,1186,76,52,13,3,284,1614,1502,1927,7307,1241,574,385,12936,14550
Meghalaya,East Khasi Hills,Indigenous(Desi),11134,1976,865,4254,253,7045,25527,7714,10328,7398,5094,4519,2779,37832,63359
Meghalaya,North Garo Hills,Exotic,6,2,0,4,0,0,12,4,2,4,0,0,0,10,22
Meghalaya,North Garo Hills,Indigenous(Desi),10566,1204,307,21933,330,650,34990,8391,5987,10926,6361,5544,454,37663,72653
Meghalaya,Ri Bhoi,Exotic,1000,42,30,8,0,28,1108,1989,839,11757,517,181,77,15360,16468
Meghalaya,Ri Bhoi,Indigenous(Desi),4862,1241,385,8840,98,1105,16531,3757,4871,6826,3057,2537,515,21563,38094
Meghalaya,South Garo Hills,Indigenous(Desi),7509,4602,1548,7548,1079,1903,24189,11527,10749,12197,10143,4655,1226,50497,74686
Meghalaya,South West Garo Hills,Exotic,0,0,0,0,0,0,0,2,2,10,0,0,0,14,14
Meghalaya,South West Garo Hills,Indigenous(Desi),10490,1765,1443,15579,761,975,31013,13485,12350,16467,16207,8341,1147,67997,99010
Meghalaya,South West Khasi Hills,Indigenous(Desi),5618,1080,159,1272,41,3683,11853,4357,4412,4645,3106,2104,2255,20879,32732
Meghalaya,West Garo Hills,Exotic,136,33,99,3,0,12,283,150,152,255,35,36,2,630,913
Meghalaya,West Garo Hills,Indigenous(Desi),27602,9549,4020,35719,1649,5969,84508,29873,24467,35328,27626,17516,2790,137600,222108
Meghalaya,West Jaintia Hills,Exotic,16,4,0,14,0,8,42,20,39,44,8,9,22,142,184
Meghalaya,West Jaintia Hills,Indigenous(Desi),9557,3462,170,14088,376,3902,31555,4814,6266,3476,4894,4959,1474,25883,57438
Meghalaya,West Khasi Hills,Exotic,50,0,4,8,0,15,77,30,12,24,12,27,31,136,213
Meghalaya,West Khasi Hills,Indigenous(Desi),9772,2964,440,7264,341,4947,25728,10438,11215,11494,8700,6402,4263,52512,78240
Mizoram,AIZAWL,Exotic,844,152,77,47,21,82,1223,1471,1080,3272,1003,896,79,7801,9024
Mizoram,AIZAWL,Indigenous(Desi),195,105,22,18,6,50,396,216,186,280,164,135,34,1015,1411
Mizoram,CHAMPHAI,Exotic,335,231,51,117,12,21,767,469,323,683,369,345,90,2279,3046
Mizoram,CHAMPHAI,Indigenous(Desi),681,521,182,249,50,142,1825,675,774,940,928,557,139,4013,5838
Mizoram,KOLASIB,Exotic,398,102,197,61,15,18,791,645,479,1187,433,302,52,3098,3889
Mizoram,KOLASIB,Indigenous(Desi),515,85,636,118,83,52,1489,212,222,385,242,189,35,1285,2774
Mizoram,LAWNGTLAI,Exotic,165,59,39,57,0,14,334,149,149,183,103,74,12,670,1004
Mizoram,LAWNGTLAI,Indigenous(Desi),710,317,570,314,70,158,2139,491,617,544,559,329,102,2642,4781
Mizoram,LUNGLEI,Exotic,131,78,41,34,7,1,292,236,220,476,159,145,23,1259,1551
Mizoram,LUNGLEI,Indigenous(Desi),676,479,146,155,14,20,1490,478,418,770,427,506,23,2622,4112
Mizoram,MAMIT,Exotic,109,77,7,54,0,7,254,142,83,266,106,102,19,718,972
Mizoram,MAMIT,Indigenous(Desi),235,150,43,32,2,21,483,245,239,419,238,199,18,1358,1841
Mizoram,SERCHHIP,Exotic,126,41,17,11,16,36,247,204,129,377,125,120,53,1008,1255
Mizoram,SERCHHIP,Indigenous(Desi),280,171,51,43,5,26,576,158,213,220,249,190,17,1047,1623
Mizoram,SIAHA,Exotic,89,42,13,28,0,16,188,87,64,141,94,92,48,526,714
Mizoram,SIAHA,Indigenous(Desi),276,206,77,110,13,18,700,215,170,324,242,168,47,1166,1866
Nagaland,Dimapur,Exotic,444,316,494,186,28,67,1535,766,644,1082,352,367,94,3305,4840
Nagaland,Dimapur,Indigenous(Desi),2096,539,5985,477,244,376,9717,1353,1412,1436,516,682,299,5698,15415
Nagaland,Kiphire,Exotic,4,11,7,7,0,0,29,4,2,0,0,0,0,6,35
Nagaland,Kiphire,Indigenous(Desi),187,11,2,3,0,600,803,36,195,27,3,17,314,592,1395
Nagaland,Kohima,Exotic,392,261,191,116,7,43,1010,781,995,1781,566,833,100,5056,6066
Nagaland,Kohima,Indigenous(Desi),403,99,179,88,1,8,778,202,255,222,121,196,9,1005,1783
Nagaland,Longleng,Exotic,181,272,3,0,0,79,535,457,253,431,86,187,16,1430,1965
Nagaland,Longleng,Indigenous(Desi),546,791,34,11,2,161,1545,1599,1008,1282,276,521,48,4734,6279
Nagaland,Mokokchung,Exotic,69,56,26,45,2,3,201,132,95,209,62,52,2,552,753
Nagaland,Mokokchung,Indigenous(Desi),412,11,190,137,221,12,983,86,142,106,10,1,0,345,1328
Nagaland,Mon,Exotic,13,0,0,0,0,0,13,4,6,5,1,0,0,16,29
Nagaland,Mon,Indigenous(Desi),2586,780,1215,427,271,42,5321,1334,1196,1348,357,164,33,4432,9753
Nagaland,Peren,Exotic,39,32,10,5,0,2,88,64,46,97,57,31,5,300,388
Nagaland,Peren,Indigenous(Desi),1568,515,668,677,36,91,3555,1235,1586,1351,452,395,56,5075,8630
Nagaland,Phek,Exotic,64,60,1,0,0,0,125,155,148,220,89,43,9,664,789
Nagaland,Phek,Indigenous(Desi),238,359,5,16,0,35,653,291,250,493,122,147,19,1322,1975
Nagaland,Tuensang,Exotic,372,184,55,224,69,49,953,280,379,240,217,78,28,1222,2175
Nagaland,Tuensang,Indigenous(Desi),538,280,97,18,2,198,1133,386,504,91,104,79,106,1270,2403
Nagaland,Wokha,Exotic,9,11,0,1,0,3,24,20,25,52,14,17,4,132,156
Nagaland,Wokha,Indigenous(Desi),370,262,379,98,29,20,1158,211,224,324,78,130,18,985,2143
Nagaland,Zunheboto,Exotic,132,91,68,122,47,103,563,153,115,156,92,68,58,642,1205
Nagaland,Zunheboto,Indigenous(Desi),1949,651,1609,340,187,531,5267,850,996,798,323,268,289,3524,8791
Odisha,Anugul,Exotic,3502,276,2115,226,836,48,7003,8204,4779,10873,3734,816,241,28647,35650
Odisha,Anugul,Indigenous(Desi),31345,3434,95523,2087,44760,2487,179636,41870,24439,54413,21132,4920,2203,148977,328613
Odisha,Balangir,Exotic,9956,1058,32605,865,1663,302,46449,21342,11880,29643,10851,1717,459,75892,122341
Odisha,Balangir,Indigenous(Desi),10836,1362,101305,2036,6360,1447,123346,18517,10861,25578,9033,1688,841,66518,189864
Odisha,Baleshwar,Exotic,2907,192,366,74,89,47,3675,9414,6804,12764,4666,879,167,34694,38369
Odisha,Baleshwar,Indigenous(Desi),69141,5846,43422,2922,5773,1403,128507,121835,99094,145837,72254,13500,2732,455252,583759
Odisha,Bargarh,Exotic,13242,668,20474,825,335,230,35774,23238,17047,33573,17982,4686,1248,97774,133548
Odisha,Bargarh,Indigenous(Desi),9193,1299,59827,837,4396,705,76257,9317,4831,12039,6620,1704,439,34950,111207
Odisha,Bhadrak,Exotic,1838,164,143,86,21,11,2263,10354,6569,13839,4226,842,89,35919,38182
Odisha,Bhadrak,Indigenous(Desi),37369,3310,10002,947,1304,665,53597,106121,69148,118851,52612,10575,3061,360368,413965
Odisha,Boudh,Exotic,1799,361,3812,162,745,126,7005,3139,1582,4278,1707,579,128,11413,18418
Odisha,Boudh,Indigenous(Desi),9154,1433,41217,3098,9605,571,65078,12518,7610,15223,7968,2368,448,46135,111213
Odisha,Cuttack,Exotic,11937,1168,2004,1058,442,366,16975,76948,42736,107576,33801,6848,2819,270728,287703
Odisha,Cuttack,Indigenous(Desi),25864,1080,21875,517,4740,460,54536,58018,40470,68059,31681,4965,3338,206531,261067
Odisha,Deogarh,Exotic,160,7,219,5,62,6,459,527,238,654,326,83,14,1842,2301
Odisha,Deogarh,Indigenous(Desi),7666,366,49895,348,21223,574,80072,11015,7922,13230,10308,3152,338,45965,126037
Odisha,Dhenkanal,Exotic,1208,17,559,7,11,31,1833,2072,1706,3003,1161,159,13,8114,9947
Odisha,Dhenkanal,Indigenous(Desi),46669,1567,43125,1902,3633,1158,98054,67250,56979,89455,46174,7034,1303,268195,366249
Odisha,Gajapati,Exotic,1222,179,2556,327,271,21,4576,2254,1405,3329,1058,236,47,8329,12905
Odisha,Gajapati,Indigenous(Desi),16118,1982,79621,5851,3412,377,107361,12517,8941,16548,8042,1138,212,47398,154759
Odisha,Ganjam,Exotic,2839,115,312,57,55,44,3422,6362,3629,9686,3275,472,155,23579,27001
Odisha,Ganjam,Indigenous(Desi),45566,4410,74966,2337,12023,1615,140917,69463,51003,97806,46218,10250,3255,277995,418912
Odisha,Jagatsinghapur,Exotic,6994,502,689,55,74,19,8333,51649,28955,69312,18116,1367,334,169733,178066
Odisha,Jagatsinghapur,Indigenous(Desi),2287,71,774,18,196,12,3358,8121,5716,10051,4369,276,21,28554,31912
Odisha,Jajapur,Exotic,2557,119,184,32,67,32,2991,7696,6184,10536,4664,461,129,29670,32661
Odisha,Jajapur,Indigenous(Desi),43801,2104,22359,1109,3243,1117,73733,103146,82783,113920,64262,6261,1744,372116,445849
Odisha,Jharsuguda,Exotic,2749,61,1484,28,11,28,4361,3846,2478,5712,3244,468,46,15794,20155
Odisha,Jharsuguda,Indigenous(Desi),7636,259,33396,364,752,374,42781,8085,5851,10484,7129,1036,117,32702,75483
Odisha,Kalahandi,Exotic,5148,372,13731,206,1906,173,21536,10282,4937,13489,5111,942,225,34986,56522
Odisha,Kalahandi,Indigenous(Desi),18796,1922,100163,2567,15553,768,139769,24392,13736,28257,18854,2323,680,88242,228011
Odisha,Kandhamal,Exotic,103,1,81,2,7,11,205,269,198,431,168,29,27,1122,1327
Odisha,Kandhamal,Indigenous(Desi),32001,3571,151248,8172,1583,1390,197965,14769,10077,17029,15925,2976,940,61716,259681
Odisha,Kendrapara,Exotic,4704,306,201,56,71,246,5584,26590,16260,33630,13878,3904,885,95147,100731
Odisha,Kendrapara,Indigenous(Desi),16717,1202,3315,371,290,441,22336,53831,40844,62368,30810,9018,2546,199417,221753
Odisha,Kendujhar,Exotic,2603,155,1090,75,273,97,4293,7363,4394,9443,3131,1009,336,25676,29969
Odisha,Kendujhar,Indigenous(Desi),71232,7242,207144,23552,33025,3330,345525,72543,45781,79726,37041,13071,3177,251339,596864
Odisha,Khordha,Exotic,4336,724,1017,277,203,307,6864,14224,9810,23555,7170,2147,1062,57968,64832
Odisha,Khordha,Indigenous(Desi),25467,1592,16522,1020,9192,2337,56130,41430,31030,52115,23725,4458,2611,155369,211499
Odisha,Koraput,Exotic,1572,165,631,45,59,50,2522,2847,2052,4455,2048,336,95,11833,14355
Odisha,Koraput,Indigenous(Desi),37477,4631,179601,21015,6661,1151,250536,38374,34695,50224,46576,7469,1549,178887,429423
Odisha,Malkangiri,Exotic,506,74,144,83,3,16,826,1081,628,1530,562,140,61,4002,4828
Odisha,Malkangiri,Indigenous(Desi),30785,3498,90222,16309,3341,2863,147018,30987,31059,37385,40436,5825,3273,148965,295983
Odisha,Mayurbhanj,Exotic,2705,84,1047,51,128,60,4075,6323,3863,8777,4050,1271,274,24558,28633
Odisha,Mayurbhanj,Indigenous(Desi),62185,11646,273426,6009,13448,3493,370207,68700,52020,81966,52899,15102,3915,274602,644809
Odisha,Nabarangpur,Exotic,1326,102,1488,21,89,29,3055,3757,2923,5187,2570,239,132,14808,17863
Odisha,Nabarangpur,Indigenous(Desi),24865,5495,200148,2145,3418,1122,237193,20211,15610,24422,19957,2547,878,83625,320818
Odisha,Nayagarh,Exotic,451,14,89,4,5,12,575,1372,871,2076,751,125,94,5289,5864
Odisha,Nayagarh,Indigenous(Desi),23924,717,45753,572,7760,462,79188,32636,26014,43543,20224,1755,868,125040,204228
Odisha,Nuapada,Exotic,697,224,1385,10,10,13,2339,1544,1111,1963,1152,142,39,5951,8290
Odisha,Nuapada,Indigenous(Desi),12267,6407,81119,3083,852,1111,104839,10103,8034,12772,10247,645,641,42442,147281
Odisha,Puri,Exotic,7472,288,858,214,121,148,9101,46088,26751,63410,21515,3285,822,161871,170972
Odisha,Puri,Indigenous(Desi),14506,917,14781,1624,2716,568,35112,45485,29604,55689,25948,3306,1034,161066,196178
Odisha,Rayagada,Exotic,871,90,1462,40,40,89,2592,1611,938,2448,856,185,113,6151,8743
Odisha,Rayagada,Indigenous(Desi),21200,3319,108877,7436,590,2248,143670,23165,19359,28340,16881,4734,2367,94846,238516
Odisha,Sambalpur,Exotic,4175,219,4211,122,100,160,8987,6289,4177,11121,5887,1338,304,29116,38103
Odisha,Sambalpur,Indigenous(Desi),21583,3804,97270,2077,9152,2439,136325,16015,12113,24301,16272,3337,1329,73367,209692
Odisha,Sonepur,Exotic,3708,1105,6674,715,1903,270,14375,8980,4916,12963,4772,2103,196,33930,48305
Odisha,Sonepur,Indigenous(Desi),4797,574,26473,474,2210,366,34894,7444,4046,10049,5465,1979,151,29134,64028
Odisha,Sundargarh,Exotic,2096,132,1933,41,196,82,4480,4681,2642,7283,3957,569,184,19316,23796
Odisha,Sundargarh,Indigenous(Desi),44857,7066,196541,2758,41335,6531,299088,32819,23258,38346,30471,7308,4647,136849,435937
Puducherry,Karaikal,Exotic,371,32,9,6,32,7,457,3825,2813,6030,1365,854,119,15006,15463
Puducherry,Karaikal,Indigenous(Desi),328,197,121,45,84,48,823,499,507,567,161,281,54,2069,2892
Puducherry,Mahe,Exotic,0,0,0,0,0,0,0,56,44,82,3,0,0,185,185
Puducherry,Mahe,Indigenous(Desi),0,0,0,0,0,0,0,34,35,40,1,1,0,111,111
Puducherry,Pondicherry,Exotic,1918,115,110,87,224,43,2497,11786,10559,17890,5699,1365,646,47945,50442
Puducherry,Pondicherry,Indigenous(Desi),83,48,75,8,592,32,838,233,255,514,236,23,29,1290,2128
Puducherry,Yanam,Exotic,1,0,0,0,0,0,1,37,10,50,44,6,1,148,149
Puducherry,Yanam,Indigenous(Desi),1,2,0,0,0,1,4,41,26,132,398,13,0,610,614
Punjab,Amritsar,Exotic,2896,320,520,910,723,251,5620,30733,30340,88743,19434,1703,590,171543,177163
Punjab,Amritsar,Indigenous(Desi),328,55,31,101,81,168,764,2441,2135,6541,1719,312,45,13193,13957
Punjab,Barnala,Exotic,1047,57,183,27,321,398,2033,8563,7762,24410,5634,485,114,46968,49001
Punjab,Barnala,Indigenous(Desi),816,284,1050,10,3297,343,5800,1514,1779,2441,2967,661,438,9800,15600
Punjab,Bathinda,Exotic,3770,162,470,61,751,718,5932,26309,19075,54305,13847,1406,1582,116524,122456
Punjab,Bathinda,Indigenous(Desi),1966,314,1148,32,1902,1776,7138,5411,4046,8634,4827,1380,1564,25862,33000
Punjab,Faridkot,Exotic,1023,128,186,86,99,187,1709,11998,10353,28936,6563,392,159,58401,60110
Punjab,Faridkot,Indigenous(Desi),682,227,638,35,554,224,2360,1345,1483,3066,1455,508,145,8002,10362
Punjab,Fatehgarh Sahib,Exotic,750,84,326,63,230,113,1566,10598,10320,28266,7708,489,122,57503,59069
Punjab,Fatehgarh Sahib,Indigenous(Desi),265,75,809,26,1541,95,2811,1369,1114,3475,621,137,59,6775,9586
Punjab,Fazilka,Exotic,2639,75,335,35,298,132,3514,18418,14391,36250,11045,1964,437,82505,86019
Punjab,Fazilka,Indigenous(Desi),3010,327,2300,261,3945,408,10251,12839,10057,23483,9999,1829,539,58746,68997
Punjab,Firozepur,Exotic,797,121,226,73,267,18,1502,13461,13973,40581,11818,813,201,80847,82349
Punjab,Firozepur,Indigenous(Desi),158,58,231,18,161,47,673,1406,1318,3938,1277,156,62,8157,8830
Punjab,Gurdaspur,Exotic,2335,172,238,261,425,90,3521,33693,24589,82088,19924,1575,319,162188,165709
Punjab,Gurdaspur,Indigenous(Desi),191,28,26,30,72,52,399,3703,2277,7852,1827,108,47,15814,16213
Punjab,Hoshiarpur,Exotic,2248,122,1315,222,754,183,4844,24123,19444,62738,15656,1675,612,124248,129092
Punjab,Hoshiarpur,Indigenous(Desi),717,90,1391,66,758,69,3091,5159,3003,9362,1743,245,212,19724,22815
Punjab,Jalandhar,Exotic,2206,392,589,391,551,524,4653,26345,19991,75269,16904,1585,504,140598,145251
Punjab,Jalandhar,Indigenous(Desi),271,220,187,62,117,73,930,578,760,1956,903,252,69,4518,5448
Punjab,Kapurthala,Exotic,1273,49,432,246,198,239,2437,13953,10017,33886,8318,205,96,66475,68912
Punjab,Kapurthala,Indigenous(Desi),77,22,57,5,48,42,251,530,692,1867,385,28,17,3519,3770
Punjab,Ludhiana,Exotic,3402,266,1232,387,1813,572,7672,32595,29693,103988,27563,2357,874,197070,204742
Punjab,Ludhiana,Indigenous(Desi),1185,242,3193,326,4757,858,10561,1607,1686,5323,2608,245,528,11997,22558
Punjab,Mansa,Exotic,2311,91,359,259,161,1156,4337,10892,8554,20339,5524,677,1313,47299,51636
Punjab,Mansa,Indigenous(Desi),2138,349,1530,190,2767,980,7954,4639,3499,7703,3066,1419,3399,23725,31679
Punjab,Moga,Exotic,1110,72,300,27,268,204,1981,17282,15739,47740,8942,501,304,90508,92489
Punjab,Moga,Indigenous(Desi),1173,151,765,197,947,666,3899,1939,1556,2794,1353,1016,4002,12660,16559
Punjab,Muktsar,Exotic,1934,121,205,60,311,449,3080,16504,16626,41735,9405,857,414,85541,88621
Punjab,Muktsar,Indigenous(Desi),1003,96,560,17,1388,345,3409,4439,4111,9026,2641,291,564,21072,24481
Punjab,Nawanshahr (Sbs Nagar),Exotic,575,19,288,42,242,72,1238,11385,7412,33133,6160,431,137,58658,59896
Punjab,Nawanshahr (Sbs Nagar),Indigenous(Desi),250,39,453,3,192,88,1025,224,318,547,607,16,45,1757,2782
Punjab,Pathankot,Exotic,2040,88,277,116,44,44,2609,10447,8655,27830,5806,1123,276,54137,56746
Punjab,Pathankot,Indigenous(Desi),1241,21,2227,87,25,17,3618,2814,3231,6613,2836,152,699,16345,19963
Punjab,Patiala,Exotic,2282,188,326,65,655,997,4513,18979,15076,53265,10474,737,862,99393,103906
Punjab,Patiala,Indigenous(Desi),966,632,1402,132,2026,374,5532,2050,2495,5568,1919,942,1736,14710,20242
Punjab,Rupnagar,Exotic,526,61,301,36,446,206,1576,11067,11738,33154,8479,1116,179,65733,67309
Punjab,Rupnagar,Indigenous(Desi),157,34,867,63,1378,33,2532,495,595,1276,504,101,32,3003,5535
Punjab,S.A.S Nagar,Exotic,610,37,172,62,260,153,1294,5461,5621,17009,4688,435,161,33375,34669
Punjab,S.A.S Nagar,Indigenous(Desi),379,17,237,36,2073,160,2902,788,625,1802,800,79,34,4128,7030
Punjab,Sangrur,Exotic,2336,183,494,70,628,505,4216,19161,16642,55172,12293,1134,762,105164,109380
Punjab,Sangrur,Indigenous(Desi),3650,851,5699,208,8868,856,20132,5654,5727,10104,5886,1179,2425,30975,51107
Punjab,Tarn Taran,Exotic,1423,150,420,459,564,47,3063,14798,16201,43550,10501,2053,896,87999,91062
Punjab,Tarn Taran,Indigenous(Desi),304,16,259,79,325,13,996,2052,2478,7597,1809,333,94,14363,15359
Rajasthan,Ajmer,Exotic,5796,240,150,36,83,132,6437,18005,12804,29496,11346,2174,309,74134,80571
Rajasthan,Ajmer,Indigenous(Desi),26313,1253,2648,445,883,751,32293,65573,48366,99155,48935,8402,1362,271793,304086
Rajasthan,Alwar,Exotic,5634,74,57,39,17,520,6341,24863,15848,37907,12636,2281,786,94321,100662
Rajasthan,Alwar,Indigenous(Desi),7550,626,350,87,145,2434,11192,32714,25335,45454,21053,3159,2287,130002,141194
Rajasthan,Banswara,Exotic,1215,193,1669,934,65,64,4140,4465,3753,8013,5433,548,314,22526,26666
Rajasthan,Banswara,Indigenous(Desi),38510,7431,245368,25608,2509,1567,320993,62574,59609,94243,79024,8865,5415,309730,630723
Rajasthan,Baran,Exotic,200,19,17,1,0,3,240,633,398,943,545,46,17,2582,2822
Rajasthan,Baran,Indigenous(Desi),26784,3595,9345,1070,477,1201,42472,63089,41480,85543,56669,5044,984,252809,295281
Rajasthan,Barmer,Exotic,101,7,0,2,0,0,110,407,213,647,131,18,34,1450,1560
Rajasthan,Barmer,Indigenous(Desi),47541,10256,1583,1628,1184,4215,66407,236342,143256,309263,121326,21187,5858,837232,903639
Rajasthan,Bharatpur,Exotic,4612,62,168,39,129,294,5304,18649,12046,29733,8359,1461,279,70527,75831
Rajasthan,Bharatpur,Indigenous(Desi),7922,451,1365,349,315,2323,12725,29644,19724,43615,19049,3209,1604,116845,129570
Rajasthan,Bhilwara,Exotic,9536,193,815,49,72,320,10985,29600,19788,47965,26301,4291,1090,129035,140020
Rajasthan,Bhilwara,Indigenous(Desi),42073,1601,30332,1468,2180,3151,80805,108704,77071,158575,118981,16399,4868,484598,565403
Rajasthan,Bikaner,Exotic,5470,502,196,95,112,1305,7680,27488,20058,54347,13195,4782,2627,122497,130177
Rajasthan,Bikaner,Indigenous(Desi),71129,8775,3301,1087,3074,12957,100323,236709,204617,342857,146342,26096,7608,964229,1064552
Rajasthan,Bundi,Exotic,1152,67,29,20,4,34,1306,4740,3173,6206,3310,471,49,17949,19255
Rajasthan,Bundi,Indigenous(Desi),11218,741,4106,446,243,765,17519,41314,26929,51000,32581,3758,1153,156735,174254
Rajasthan,Chittorgarh,Exotic,2374,130,271,54,41,45,2915,8058,5035,12143,5036,886,325,31483,34398
Rajasthan,Chittorgarh,Indigenous(Desi),27765,2934,33631,3632,1317,1223,70502,65683,48811,92097,57134,7878,2523,274126,344628
Rajasthan,Churu,Exotic,3189,117,73,29,85,462,3955,16844,8944,25369,3933,951,465,56506,60461
Rajasthan,Churu,Indigenous(Desi),18785,2013,1583,775,2367,8263,33786,89236,67910,131248,37110,11565,7267,344336,378122
Rajasthan,Dausa,Exotic,1669,66,40,10,6,131,1922,13059,6789,19170,7427,1374,773,48592,50514
Rajasthan,Dausa,Indigenous(Desi),3223,175,336,58,114,257,4163,27403,14902,37603,14041,1929,970,96848,101011
Rajasthan,Dholpur,Exotic,583,12,5,1,0,52,653,5238,2505,8921,2359,594,106,19723,20376
Rajasthan,Dholpur,Indigenous(Desi),1505,64,282,48,45,91,2035,11099,6672,18969,8818,667,121,46346,48381
Rajasthan,Dungarpur,Exotic,462,22,279,32,3,5,803,1164,1113,2394,933,231,30,5865,6668
Rajasthan,Dungarpur,Indigenous(Desi),28342,3704,167218,7753,1017,995,209029,46917,38341,65618,56655,6418,1755,215704,424733
Rajasthan,Ganganagar,Exotic,11038,313,2014,261,857,1792,16275,34885,36204,72455,21993,4774,767,171078,187353
Rajasthan,Ganganagar,Indigenous(Desi),26280,1689,9269,859,4548,6705,49350,77347,88905,144148,68441,14432,6726,399999,449349
Rajasthan,Hanumangarh,Exotic,7632,715,1023,102,917,1612,12001,32445,25068,56634,17302,5260,1253,137962,149963
Rajasthan,Hanumangarh,Indigenous(Desi),26047,3990,11754,556,6397,9464,58208,72909,66519,116938,52937,13482,13308,336093,394301
Rajasthan,Jaipur,Exotic,10008,339,173,39,25,2964,13548,88662,63691,145829,56760,6550,862,362354,375902
Rajasthan,Jaipur,Indigenous(Desi),13684,2974,491,177,526,5249,23101,76989,49078,106680,51831,6646,1230,292454,315555
Rajasthan,Jaisalmer,Exotic,1773,1686,1628,1628,1688,1379,9782,2017,1144,1562,1681,1117,851,8372,18154
Rajasthan,Jaisalmer,Indigenous(Desi),19656,3662,1682,1824,2520,3033,32377,73435,63364,102087,75781,23181,18669,356517,388894
Rajasthan,Jalore,Exotic,240,12,6,5,7,3,273,2109,1716,3232,1456,89,33,8635,8908
Rajasthan,Jalore,Indigenous(Desi),19623,3266,1667,500,2157,13768,40981,62026,47509,85684,40864,8245,5042,249370,290351
Rajasthan,Jhalawar,Exotic,385,73,231,130,17,23,859,2177,1554,2370,1418,233,128,7880,8739
Rajasthan,Jhalawar,Indigenous(Desi),11295,1579,15848,1260,527,907,31416,58913,31966,71249,40772,5191,2577,210668,242084
Rajasthan,Jhunjhunu,Exotic,4857,335,287,67,167,680,6393,41044,37777,81329,20715,6707,1591,189163,195556
Rajasthan,Jhunjhunu,Indigenous(Desi),1909,491,266,99,196,699,3660,15315,12985,27273,10416,2883,1008,69880,73540
Rajasthan,Jodhpur,Exotic,5895,429,40,14,14,627,7019,20813,12063,36062,10444,1570,417,81369,88388
Rajasthan,Jodhpur,Indigenous(Desi),70195,6737,1473,1966,1099,9510,90980,235162,170592,317737,136655,19265,10248,889659,980639
Rajasthan,Karauli,Exotic,632,34,45,23,4,2,740,2732,1654,4030,1431,126,41,10014,10754
Rajasthan,Karauli,Indigenous(Desi),2633,134,1834,77,43,36,4757,15585,10251,20784,9980,759,285,57644,62401
Rajasthan,Kota,Exotic,671,23,7,2,0,11,714,1548,1157,2928,1259,444,101,7437,8151
Rajasthan,Kota,Indigenous(Desi),20565,1231,2432,378,329,1696,26631,38910,26190,59651,47315,7876,1619,181561,208192
Rajasthan,Nagaur,Exotic,5065,369,43,38,243,975,6733,22639,15372,31621,12290,2482,483,84887,91620
Rajasthan,Nagaur,Indigenous(Desi),27840,4658,1090,512,1973,7077,43150,105511,71543,145328,98395,13920,4524,439221,482371
Rajasthan,Pali,Exotic,1298,91,22,20,50,133,1614,3577,2438,5936,2430,372,63,14816,16430
Rajasthan,Pali,Indigenous(Desi),28567,2844,5385,782,2015,5484,45077,68876,54043,105119,60725,6547,4054,299364,344441
Rajasthan,Pratapgarh,Exotic,1072,35,236,10,7,10,1370,5419,3230,7667,4108,800,222,21446,22816
Rajasthan,Pratapgarh,Indigenous(Desi),24020,1851,103407,9292,2193,435,141198,46713,31551,67508,56584,7313,2119,211788,352986
Rajasthan,Rajsamand,Exotic,1744,226,338,34,17,15,2374,8155,5222,13442,5715,1202,161,33897,36271
Rajasthan,Rajsamand,Indigenous(Desi),14505,798,18813,1583,1263,397,37359,41960,23714,62961,32953,8144,1369,171101,208460
Rajasthan,Sawai Madhopur,Exotic,275,1,3,1,12,0,292,1665,644,2570,719,117,50,5765,6057
Rajasthan,Sawai Madhopur,Indigenous(Desi),4235,302,706,22,143,363,5771,18544,8308,26374,11120,1047,406,65799,71570
Rajasthan,Sikar,Exotic,9373,289,322,191,512,381,11068,60493,39318,109880,22704,3886,485,236766,247834
Rajasthan,Sikar,Indigenous(Desi),6183,846,376,243,512,1481,9641,29871,20701,50253,21447,3034,760,126066,135707
Rajasthan,Sirohi,Exotic,582,314,338,345,317,298,2194,1906,1734,3084,1507,370,67,8668,10862
Rajasthan,Sirohi,Indigenous(Desi),11674,2466,21426,1629,499,1224,38918,32210,28378,52666,33657,6894,1518,155323,194241
Rajasthan,Tonk,Exotic,661,8,18,5,3,3,698,2344,1048,3363,1259,335,36,8385,9083
Rajasthan,Tonk,Indigenous(Desi),10043,326,1314,48,450,423,12604,42718,19539,57875,24592,4689,636,150049,162653
Rajasthan,Udaipur,Exotic,3032,89,1032,46,15,71,4285,17171,12025,31992,11907,2512,319,75926,80211
Rajasthan,Udaipur,Indigenous(Desi),40280,3367,233968,19222,13400,2347,312584,96097,80453,135777,110843,12440,3091,438701,751285
Sikkim,East District,Exotic,4610,225,3827,767,100,145,9674,7873,4856,15251,3802,2352,412,34546,44220
Sikkim,East District,Indigenous(Desi),229,42,201,30,5,16,523,659,401,647,228,76,110,2121,2644
Sikkim,North District,Exotic,1261,126,685,319,94,103,2588,1778,473,2850,1077,639,24,6841,9429
Sikkim,North District,Indigenous(Desi),399,134,129,101,3,4,770,361,544,538,186,71,19,1719,2489
Sikkim,South District,Exotic,2661,153,2646,906,12,26,6404,7157,4833,11809,2964,1160,131,28054,34458
Sikkim,South District,Indigenous(Desi),1434,193,2001,387,47,154,4216,2123,1543,3045,866,265,73,7915,12131
Sikkim,West District,Exotic,1980,215,2959,59,92,138,5443,6496,3614,9602,2698,738,152,23300,28743
Sikkim,West District,Indigenous(Desi),1600,191,1194,395,224,85,3689,2787,1616,4258,1228,184,134,10207,13896
Tamil Nadu,Ariyalur,Exotic,6679,847,586,413,793,178,9496,31102,21837,38553,15929,1668,986,110075,119571
Tamil Nadu,Ariyalur,Indigenous(Desi),2188,505,874,356,1934,274,6131,9545,6939,13192,5163,320,232,35391,41522
Tamil Nadu,Chennai,Exotic,875,232,19,25,37,96,1284,2474,1993,8125,1219,299,303,14413,15697
Tamil Nadu,Chennai,Indigenous(Desi),796,180,28,20,152,600,1776,1310,1394,3861,1175,137,238,8115,9891
Tamil Nadu,Coimbatore,Exotic,2305,851,544,619,299,314,4932,46682,43397,110985,19776,4928,2583,228351,233283
Tamil Nadu,Coimbatore,Indigenous(Desi),1450,463,734,421,996,966,5030,5184,4033,8642,2753,793,199,21604,26634
Tamil Nadu,Cuddalore,Exotic,8198,1583,1387,679,2146,708,14701,76073,51324,109219,29402,7769,3167,276954,291655
Tamil Nadu,Cuddalore,Indigenous(Desi),1920,402,1052,280,2077,82,5813,14887,11130,23110,4634,1306,1128,56195,62008
Tamil Nadu,Dharmapuri,Exotic,5762,948,1229,380,182,364,8865,75045,56495,142453,43869,6902,2371,327135,336000
Tamil Nadu,Dharmapuri,Indigenous(Desi),1414,421,2112,517,371,92,4927,3548,4490,6577,3357,634,255,18861,23788
Tamil Nadu,Dindigul,Exotic,5550,974,1795,637,549,126,9631,64872,43959,121813,22939,4889,1321,259793,269424
Tamil Nadu,Dindigul,Indigenous(Desi),1516,238,2200,258,541,253,5006,4826,4095,9176,2420,1254,803,22574,27580
Tamil Nadu,Erode,Exotic,6885,1762,1720,897,655,464,12383,54547,44374,111024,29430,13116,3231,255722,268105
Tamil Nadu,Erode,Indigenous(Desi),3968,1483,3776,980,1134,341,11682,12822,11532,20849,8231,5954,1251,60639,72321
Tamil Nadu,Kanchipuram,Exotic,9611,1571,1398,364,599,454,13997,46020,30974,67800,21500,5622,2583,174499,188496
Tamil Nadu,Kanchipuram,Indigenous(Desi),13880,3728,7326,1648,2711,891,30184,52844,46812,70391,29637,7830,2264,209778,239962
Tamil Nadu,Kanniyakumari,Exotic,2624,363,324,189,60,136,3696,17052,11675,26762,4840,1455,717,62501,66197
Tamil Nadu,Kanniyakumari,Indigenous(Desi),251,178,302,114,122,131,1098,689,1056,983,172,112,64,3076,4174
Tamil Nadu,Karur,Exotic,3512,920,651,375,1189,85,6732,36501,25585,53751,17432,2692,702,136663,143395
Tamil Nadu,Karur,Indigenous(Desi),1582,446,431,237,2363,116,5175,4457,4006,6331,1214,342,116,16466,21641
Tamil Nadu,Krishnagiri,Exotic,3167,788,1060,378,241,167,5801,69504,55096,142421,29964,5352,2305,304642,310443
Tamil Nadu,Krishnagiri,Indigenous(Desi),6768,2199,7095,1639,1454,707,19862,12961,14494,25022,9817,1956,1202,65452,85314
Tamil Nadu,Madurai,Exotic,9869,2945,2626,1852,960,505,18757,41226,43908,88021,22211,4259,2548,202173,220930
Tamil Nadu,Madurai,Indigenous(Desi),6083,1522,2247,1172,987,1383,13394,6414,7117,10105,2641,1217,907,28401,41795
Tamil Nadu,Nagapattinam,Exotic,5335,1863,1496,844,502,381,10421,51094,37096,55338,19269,5703,3076,171576,181997
Tamil Nadu,Nagapattinam,Indigenous(Desi),2662,704,658,317,388,118,4847,20470,14409,19061,8882,1050,918,64790,69637
Tamil Nadu,Namakkal,Exotic,5075,370,137,46,62,28,5718,57095,49845,100681,24469,2864,604,235558,241276
Tamil Nadu,Namakkal,Indigenous(Desi),2765,364,1775,739,496,342,6481,5381,3684,7924,2473,445,132,20039,26520
Tamil Nadu,Perambalur,Exotic,4645,1430,734,205,246,27,7287,33119,18789,49651,17017,699,522,119797,127084
Tamil Nadu,Perambalur,Indigenous(Desi),405,126,527,127,369,38,1592,827,654,1489,643,119,64,3796,5388
Tamil Nadu,Pudukkottai,Exotic,10262,2201,2311,1246,750,1489,18259,60982,32764,71722,20706,5746,1876,193796,212055
Tamil Nadu,Pudukkottai,Indigenous(Desi),13816,4483,5147,3163,3201,2414,32224,37692,26122,38977,9124,2571,1534,116020,148244
Tamil Nadu,Ramanathapuram,Exotic,3347,582,288,286,154,64,4721,16966,8991,19911,6064,1078,343,53353,58074
Tamil Nadu,Ramanathapuram,Indigenous(Desi),1433,216,454,139,275,133,2650,8519,4230,9305,5152,446,90,27742,30392
Tamil Nadu,Salem,Exotic,7819,1669,2015,1393,456,261,13613,134097,105372,245986,61054,13011,3572,563092,576705
Tamil Nadu,Salem,Indigenous(Desi),4603,982,5506,879,1536,781,14287,9241,9205,16049,6336,1207,407,42445,56732
Tamil Nadu,Sivaganga,Exotic,5014,1061,912,642,478,444,8551,27788,21224,33199,8963,3540,1784,96498,105049
Tamil Nadu,Sivaganga,Indigenous(Desi),15152,3664,3302,2399,2079,3380,29976,33394,26024,36877,10053,3536,1714,111598,141574
Tamil Nadu,Thanjavur,Exotic,12653,2449,2830,1365,1708,1151,22156,64758,43367,89691,25284,4898,5106,233104,255260
Tamil Nadu,Thanjavur,Indigenous(Desi),6401,2316,2968,1025,3631,677,17018,21877,18302,27029,8103,1690,1248,78249,95267
Tamil Nadu,The Nilgiris,Exotic,413,424,90,58,5,12,1002,2589,1932,6855,969,151,134,12630,13632
Tamil Nadu,The Nilgiris,Indigenous(Desi),535,280,105,39,21,8,988,2476,3369,5089,347,117,77,11475,12463
Tamil Nadu,Theni,Exotic,2302,477,530,220,248,66,3843,19165,14674,47898,8816,496,573,91622,95465
Tamil Nadu,Theni,Indigenous(Desi),2252,639,1150,232,852,358,5483,1941,2232,3363,1471,90,230,9327,14810
Tamil Nadu,Thiruvallur,Exotic,10845,2454,3114,1244,1632,482,19771,39050,32419,66157,18423,5404,2139,163592,183363
Tamil Nadu,Thiruvallur,Indigenous(Desi),7937,1318,3383,723,1377,155,14893,21654,19311,29328,9869,2755,965,83882,98775
Tamil Nadu,Thiruvarur,Exotic,5205,1503,1414,1260,1680,801,11863,37777,28453,50805,17880,4866,2454,142235,154098
Tamil Nadu,Thiruvarur,Indigenous(Desi),1962,384,891,205,356,103,3901,11934,9448,12916,5468,1565,918,42249,46150
Tamil Nadu,Tiruchirappalli,Exotic,11590,2457,1501,1043,949,402,17942,74984,58713,117224,27345,7188,2358,287812,305754
Tamil Nadu,Tiruchirappalli,Indigenous(Desi),2782,766,1951,540,1363,703,8105,6633,5088,9016,1808,330,169,23044,31149
Tamil Nadu,Tirunelveli,Exotic,10858,3510,1700,1493,871,474,18906,67009,41627,109192,23856,6790,2412,250886,269792
Tamil Nadu,Tirunelveli,Indigenous(Desi),1564,476,802,210,379,130,3561,5444,4550,10237,3228,764,530,24753,28314
Tamil Nadu,Tiruppur,Exotic,4555,1090,736,395,323,152,7251,54912,48361,116072,26162,7352,1624,254483,261734
Tamil Nadu,Tiruppur,Indigenous(Desi),2561,931,797,459,662,64,5474,6296,6131,10545,2989,798,140,26899,32373
Tamil Nadu,Tiruvannamalai,Exotic,32640,2735,8871,1609,1823,546,48224,192681,117745,251224,61200,9390,4374,636614,684838
Tamil Nadu,Tiruvannamalai,Indigenous(Desi),4889,427,14045,566,1966,125,22018,10956,9011,8874,3103,499,168,32611,54629
Tamil Nadu,Tuticorin,Exotic,5917,1074,933,454,260,161,8799,23994,15290,39861,9058,2052,843,91098,99897
Tamil Nadu,Tuticorin,Indigenous(Desi),1677,502,1291,177,277,208,4132,3017,2761,4921,2023,659,195,13576,17708
Tamil Nadu,Vellore,Exotic,11778,2016,4978,1614,1398,621,22405,118880,94853,200741,53035,7609,4762,479880,502285
Tamil Nadu,Vellore,Indigenous(Desi),6675,1477,6540,1173,3284,1201,20350,13830,13013,21099,8513,2070,1061,59586,79936
Tamil Nadu,Villupuram,Exotic,28593,9327,8920,4419,4147,2564,57970,186195,124803,269990,73788,17880,13634,686290,744260
Tamil Nadu,Villupuram,Indigenous(Desi),8100,3693,6529,1269,5631,404,25626,28263,21504,33964,12820,4106,3279,103936,129562
Tamil Nadu,Virudhunagar,Exotic,7950,1494,717,243,105,29,10538,42501,35887,74489,20561,3776,1153,178367,188905
Tamil Nadu,Virudhunagar,Indigenous(Desi),1734,612,792,424,420,48,4030,3204,2907,5354,1760,345,88,13658,17688
Telangana,Adilabad,Exotic,381,273,261,278,377,534,2104,897,677,969,445,274,398,3660,5764
Telangana,Adilabad,Indigenous(Desi),28588,9314,64516,8182,13766,4744,129110,38548,34852,55019,27047,14804,6019,176289,305399
Telangana,BHADRADRI KOTHAGUDEM,Exotic,197,73,182,131,47,23,653,290,275,511,123,23,71,1293,1946
Telangana,BHADRADRI KOTHAGUDEM,Indigenous(Desi),27183,7441,63161,8970,7032,1930,115717,39026,37664,52675,23454,9554,3594,165967,281684
Telangana,Hyderabad,Exotic,272,62,5,3,8,26,376,1193,876,3010,602,157,52,5890,6266
Telangana,Hyderabad,Indigenous(Desi),877,480,11,7,15,322,1712,1398,1632,1846,1565,721,495,7657,9369
Telangana,JANGOAN,Exotic,2907,119,1977,76,35,18,5132,8221,5159,12602,3540,1594,363,31479,36611
Telangana,JANGOAN,Indigenous(Desi),5172,968,31195,1851,2148,390,41724,6670,5218,8592,4940,1769,1104,28293,70017
Telangana,JAYASHANKAR BHUPALAPALL,Exotic,21,3,34,10,22,0,90,130,79,189,30,10,7,445,535
Telangana,JAYASHANKAR BHUPALAPALL,Indigenous(Desi),14525,2796,41743,5344,26801,1455,92664,16930,16472,22586,11654,5668,2340,75650,168314
Telangana,JOGULAMBA GADWAL,Exotic,51,5,44,0,1,2,103,186,144,555,41,126,11,1063,1166
Telangana,JOGULAMBA GADWAL,Indigenous(Desi),4984,946,22680,3757,5619,149,38135,7726,7314,11937,5027,2789,1369,36162,74297
Telangana,Jagitial,Exotic,158,26,68,18,25,11,306,975,677,1664,387,154,21,3878,4184
Telangana,Jagitial,Indigenous(Desi),3647,729,10853,711,3232,222,19394,5751,5653,7432,3529,1231,231,23827,43221
Telangana,KAMAREDDY,Exotic,231,63,70,27,23,7,421,1897,1532,2828,871,340,208,7676,8097
Telangana,KAMAREDDY,Indigenous(Desi),6960,1742,8314,1010,2249,501,20776,18725,23139,24703,11611,3743,1363,83284,104060
Telangana,KUMURAM BHEEM ASIFABAD,Exotic,36,2,16,6,3,1,64,286,177,221,44,64,26,818,882
Telangana,KUMURAM BHEEM ASIFABAD,Indigenous(Desi),30291,5774,83122,12666,21769,1330,154952,28460,27625,33134,12113,5900,1385,108617,263569
Telangana,Karimnagar,Exotic,1757,195,595,243,144,88,3022,10372,6820,15351,4236,2462,640,39881,42903
Telangana,Karimnagar,Indigenous(Desi),1747,421,11118,2210,1090,161,16747,5360,4832,8816,2344,923,487,22762,39509
Telangana,Khammam,Exotic,194,21,261,13,9,19,517,715,740,1559,462,33,17,3526,4043
Telangana,Khammam,Indigenous(Desi),9279,1383,23187,1686,2187,511,38233,23607,14735,33550,18174,5845,2930,98841,137074
Telangana,MAHABUBABAD,Exotic,164,189,130,49,60,55,647,185,96,260,126,35,9,711,1358
Telangana,MAHABUBABAD,Indigenous(Desi),14227,2640,68547,2693,4255,1113,93475,22301,15686,28085,14581,5289,779,86721,180196
Telangana,MANCHERIAL,Exotic,227,37,341,38,56,50,749,747,527,871,200,82,59,2486,3235
Telangana,MANCHERIAL,Indigenous(Desi),17751,5017,37872,6614,16834,1324,85412,23626,23098,31113,8759,3420,1094,91110,176522
Telangana,MEDCHAL MALKAJGIRI,Exotic,1783,248,100,36,71,12,2250,4193,2211,7829,1993,690,124,17040,19290
Telangana,MEDCHAL MALKAJGIRI,Indigenous(Desi),747,188,347,71,78,62,1493,1311,1100,2403,1064,349,58,6285,7778
Telangana,Mahbubnagar,Exotic,1986,302,1657,482,182,202,4811,10050,7548,18010,4387,1680,715,42390,47201
Telangana,Mahbubnagar,Indigenous(Desi),17663,4830,40706,6211,4566,1176,75152,30530,22892,42652,12889,5644,2923,117530,192682
Telangana,Medak,Exotic,273,189,281,194,123,35,1095,1060,923,1403,635,431,105,4557,5652
Telangana,Medak,Indigenous(Desi),5087,1804,10590,3856,1346,333,23016,13178,11880,20249,9925,4086,1369,60687,83703
Telangana,NAGARKURNOOL,Exotic,1689,266,470,156,79,11,2671,10779,6777,18508,4893,1732,289,42978,45649
Telangana,NAGARKURNOOL,Indigenous(Desi),13050,1856,42871,6405,5144,903,70229,27620,17283,36779,16433,7420,2062,107597,177826
Telangana,Nalgonda,Exotic,342,198,325,149,46,28,1088,1543,1088,2452,893,214,105,6295,7383
Telangana,Nalgonda,Indigenous(Desi),16794,2693,40929,5239,3167,609,69431,30320,25394,40505,21012,7829,1582,126642,196073
Telangana,Nirmal,Exotic,127,45,171,72,48,4,467,556,513,686,186,46,26,2013,2480
Telangana,Nirmal,Indigenous(Desi),12460,2376,23381,2476,15446,669,56808,27674,26482,36319,20128,6406,2748,119757,176565
Telangana,Nizamabad,Exotic,410,44,50,803,19,4,1330,2125,1255,2837,974,528,240,7959,9289
Telangana,Nizamabad,Indigenous(Desi),6232,1401,6786,1721,718,182,17040,17272,17484,22693,10115,5829,1530,74923,91963
Telangana,PEDDAPALLI,Exotic,359,146,463,238,71,11,1288,3195,1965,4046,1320,326,68,10920,12208
Telangana,PEDDAPALLI,Indigenous(Desi),2842,558,15235,1475,3529,100,23739,5002,4693,7991,1542,604,167,19999,43738
Telangana,RAJANNA SIRCILLA,Exotic,581,280,1070,157,50,41,2179,2622,1762,4124,1033,702,63,10306,12485
Telangana,RAJANNA SIRCILLA,Indigenous(Desi),3765,584,9020,1344,757,285,15755,3717,3691,5647,1917,498,108,15578,31333
Telangana,Rangareddi,Exotic,8361,1061,2969,492,397,85,13365,37714,18972,72653,14907,4517,1397,150160,163525
Telangana,Rangareddi,Indigenous(Desi),6114,1609,14192,1262,799,256,24232,12355,8821,20856,7589,2879,569,53069,77301
Telangana,SANGAREDDY,Exotic,623,210,761,151,40,29,1814,2775,1486,4226,1276,595,118,10476,12290
Telangana,SANGAREDDY,Indigenous(Desi),8772,2443,17989,2147,5461,751,37563,21272,18989,35750,15662,9008,3295,103976,141539
Telangana,SIDDIPET,Exotic,2686,781,2084,659,855,493,7558,11073,6805,16424,4491,1452,465,40710,48268
Telangana,SIDDIPET,Indigenous(Desi),3701,1168,24952,3068,6505,605,39999,10228,6166,14766,6020,870,298,38348,78347
Telangana,SURYAPET,Exotic,346,225,150,134,87,72,1014,337,218,407,175,48,35,1220,2234
Telangana,SURYAPET,Indigenous(Desi),7029,1948,18752,3642,4120,506,35997,13483,12072,19786,7413,3112,1051,56917,92914
Telangana,VIKARABAD,Exotic,1108,164,565,111,355,12,2315,6002,2603,8449,2866,806,504,21230,23545
Telangana,VIKARABAD,Indigenous(Desi),9192,1603,42809,3120,4666,180,61570,22474,12753,30291,14299,6995,579,87391,148961
Telangana,WANAPARTHY,Exotic,277,16,65,4,30,6,398,920,441,1532,266,105,52,3316,3714
Telangana,WANAPARTHY,Indigenous(Desi),7365,946,14109,2451,1735,379,26985,11006,6230,18162,5448,2564,980,44390,71375
Telangana,WARANGAL URBAN,Exotic,479,75,220,26,59,8,867,3521,2405,5550,1273,339,102,13190,14057
Telangana,WARANGAL URBAN,Indigenous(Desi),1475,242,9462,755,2313,86,14333,2840,1661,4103,573,401,157,9735,24068
Telangana,Warangal Rural,Exotic,285,50,276,145,75,31,862,493,264,733,340,90,41,1961,2823
Telangana,Warangal Rural,Indigenous(Desi),5768,1384,42207,3479,14039,397,67274,5294,3367,8283,3414,1060,402,21820,89094
Telangana,YADADRI BHUVANAGIRI,Exotic,4969,978,1167,612,472,370,8568,12693,9020,20206,6783,3837,623,53162,61730
Telangana,YADADRI BHUVANAGIRI,Indigenous(Desi),4017,1011,9279,997,2213,520,18037,6268,4144,8331,4048,1825,582,25198,43235
Tripura,Dhalai,Exotic,343,47,105,20,23,1,539,3674,2733,3600,1680,678,38,12403,12942
Tripura,Dhalai,Indigenous(Desi),6710,1428,5862,1626,1059,233,16918,16074,13659,17148,10401,3205,332,60819,77737
Tripura,Gomati,Exotic,1486,206,188,143,20,15,2058,5573,4724,5833,2079,685,248,19142,21200
Tripura,Gomati,Indigenous(Desi),6695,1204,4339,1393,402,290,14323,19589,14641,18970,8997,2653,911,65761,80084
Tripura,Khowai,Exotic,996,23,44,7,0,6,1076,3002,2927,3734,1663,567,102,11995,13071
Tripura,Khowai,Indigenous(Desi),6550,432,4563,1131,417,222,13315,9305,9453,12086,7100,1690,1040,40674,53989
Tripura,North Tripura,Exotic,761,56,43,31,8,4,903,2178,1419,2298,753,362,44,7054,7957
Tripura,North Tripura,Indigenous(Desi),7216,796,6191,885,52,99,15239,16772,11750,17579,5887,1759,335,54082,69321
Tripura,Sepahijala,Exotic,1801,280,284,129,27,32,2553,6190,5000,6613,2360,837,190,21190,23743
Tripura,Sepahijala,Indigenous(Desi),9076,2072,5096,1772,502,291,18809,22412,20900,25383,11849,2136,617,83297,102106
Tripura,South Tripura,Exotic,530,45,35,11,6,14,641,2688,2125,3025,1432,594,95,9959,10600
Tripura,South Tripura,Indigenous(Desi),7526,1615,4387,1239,616,338,15721,25704,23350,28219,16365,4711,1022,99371,115092
Tripura,Unakoti,Exotic,251,18,24,2,1,1,297,1160,908,1233,333,171,5,3810,4107
Tripura,Unakoti,Indigenous(Desi),4489,763,4940,230,163,127,10712,13923,10848,14740,5462,1613,285,46871,57583
Tripura,West Tripura,Exotic,1716,47,124,14,3,48,1952,9302,7376,11599,3940,676,372,33265,35217
Tripura,West Tripura,Indigenous(Desi),3577,314,2829,677,167,157,7721,13004,10412,14802,5972,1836,535,46561,54282
Uttar Pradesh,Agra,Exotic,1624,1078,812,92,110,235,3951,30884,18223,48613,8263,3231,1317,110531,114482
Uttar Pradesh,Agra,Indigenous(Desi),1470,359,753,125,123,61,2891,42901,38926,65913,10390,4478,2807,165415,168306
Uttar Pradesh,Aligarh,Exotic,8731,416,2446,257,6232,198,18280,35707,18802,66334,17259,942,631,139675,157955
Uttar Pradesh,Aligarh,Indigenous(Desi),7436,379,5477,608,6166,329,20395,32251,23255,56224,16815,3648,755,132948,153343
Uttar Pradesh,Allahabad,Exotic,5372,597,1001,265,223,328,7786,43205,34669,66617,24289,3794,2381,174955,182741
Uttar Pradesh,Allahabad,Indigenous(Desi),11713,1730,8656,1041,1419,1103,25662,82643,78225,118598,48597,11772,12218,352053,377715
Uttar Pradesh,Ambedkar Nagar,Exotic,6318,1620,1798,551,151,639,11077,30823,33393,30167,18475,1588,3723,118169,129246
Uttar Pradesh,Ambedkar Nagar,Indigenous(Desi),4309,225,2477,87,106,507,7711,33181,32707,34803,18799,2463,3929,125882,133593
Uttar Pradesh,Amethi,Exotic,2792,321,453,244,47,148,4005,14917,10009,17227,8129,1144,1133,52559,56564
Uttar Pradesh,Amethi,Indigenous(Desi),13931,586,4899,613,960,681,21670,59379,55943,73482,37177,5469,5970,237420,259090
Uttar Pradesh,Amroha,Exotic,9455,189,3976,249,1410,157,15436,20990,17125,37768,10052,1299,527,87761,103197
Uttar Pradesh,Amroha,Indigenous(Desi),8418,232,8335,234,2968,152,20339,21299,19964,39662,9583,2018,587,93113,113452
Uttar Pradesh,Auraiya,Exotic,298,44,89,31,15,2,479,7632,6216,10366,3666,696,289,28865,29344
Uttar Pradesh,Auraiya,Indigenous(Desi),2276,174,941,90,103,155,3739,22309,16624,30066,9148,1441,503,80091,83830
Uttar Pradesh,Azamgarh,Exotic,6785,254,377,110,57,248,7831,55767,47174,75078,27556,4644,2868,213087,220918
Uttar Pradesh,Azamgarh,Indigenous(Desi),7492,361,2745,186,33,331,11148,60615,54699,74374,32377,2714,3613,228392,239540
Uttar Pradesh,Baghpat,Exotic,4471,122,2759,366,1304,117,9139,25801,14179,44787,9783,806,225,95581,104720
Uttar Pradesh,Baghpat,Indigenous(Desi),925,104,940,149,507,21,2646,11172,6776,15986,3943,439,248,38564,41210
Uttar Pradesh,Bahraich,Exotic,884,81,563,137,8,66,1739,5754,4461,6692,3570,459,189,21125,22864
Uttar Pradesh,Bahraich,Indigenous(Desi),16375,2096,26119,2468,1748,1010,49816,68021,52942,83912,52808,7864,5038,270585,320401
Uttar Pradesh,Ballia,Exotic,4634,150,112,54,20,297,5267,53982,50191,82991,19996,3195,1577,211932,217199
Uttar Pradesh,Ballia,Indigenous(Desi),3703,196,436,58,103,315,4811,49846,54109,68295,27114,7852,5676,212892,217703
Uttar Pradesh,Balrampur,Exotic,812,103,368,65,85,97,1530,4271,3551,5497,2020,575,232,16146,17676
Uttar Pradesh,Balrampur,Indigenous(Desi),10424,1383,23288,2902,3933,1220,43150,34645,34077,38717,19786,5574,4121,136920,180070
Uttar Pradesh,Banda,Exotic,622,443,127,7,18,43,1260,1533,1320,1056,310,72,85,4376,5636
Uttar Pradesh,Banda,Indigenous(Desi),22350,3014,52831,2378,4175,1147,85895,42998,28974,59562,25495,4418,2517,163964,249859
Uttar Pradesh,Barabanki,Exotic,2067,106,356,48,65,55,2697,13869,13292,20488,9767,998,387,58801,61498
Uttar Pradesh,Barabanki,Indigenous(Desi),13211,1324,6438,645,712,542,22872,54352,52402,77247,50728,3755,1908,240392,263264
Uttar Pradesh,Bareilly,Exotic,2421,260,621,118,119,123,3662,8613,7315,15246,4325,643,695,36837,40499
Uttar Pradesh,Bareilly,Indigenous(Desi),15813,724,9886,518,1911,573,29425,39149,34873,65113,20586,3061,2273,165055,194480
Uttar Pradesh,Basti,Exotic,2429,56,77,42,37,202,2843,15166,13896,20421,7439,950,623,58495,61338
Uttar Pradesh,Basti,Indigenous(Desi),2389,111,832,59,273,264,3928,17584,16913,18369,6272,856,443,60437,64365
Uttar Pradesh,Bijnor,Exotic,11295,440,8099,450,2453,385,23122,47795,28682,72555,18623,5640,848,174143,197265
Uttar Pradesh,Bijnor,Indigenous(Desi),15734,921,21798,1343,5997,1698,47491,36458,23861,54042,15065,2590,1518,133534,181025
Uttar Pradesh,Budaun,Exotic,5232,2706,3751,770,2386,428,15273,13132,9583,20017,7191,1520,906,52349,67622
Uttar Pradesh,Budaun,Indigenous(Desi),17968,2490,23223,3455,2269,694,50099,40354,35372,61441,20157,2783,1962,162069,212168
Uttar Pradesh,Bulandshahr,Exotic,7542,686,5465,1221,6689,261,21864,34542,24381,74757,12808,2856,1059,150403,172267
Uttar Pradesh,Bulandshahr,Indigenous(Desi),5685,343,6380,638,5475,236,18757,26760,18644,51945,11189,3356,1403,113297,132054
Uttar Pradesh,Chandauli,Exotic,3309,99,72,27,9,44,3560,47447,32049,55563,16101,2600,3099,156859,160419
Uttar Pradesh,Chandauli,Indigenous(Desi),2179,142,3466,33,14,94,5928,45339,39851,57139,24777,2808,2132,172046,177974
Uttar Pradesh,Chitrakoot,Exotic,240,17,58,31,0,3,349,1053,922,1497,745,217,55,4489,4838
Uttar Pradesh,Chitrakoot,Indigenous(Desi),18223,2399,27161,2558,2226,300,52867,53185,37838,73728,38966,4023,2295,210035,262902
Uttar Pradesh,Deoria,Exotic,4518,200,188,64,56,344,5370,52560,44432,64110,16404,3254,1766,182526,187896
Uttar Pradesh,Deoria,Indigenous(Desi),2030,977,646,456,499,2344,6952,25166,24631,28835,8023,1381,4959,92995,99947
Uttar Pradesh,Etah,Exotic,1453,108,474,20,255,117,2427,12794,7644,20310,5570,1540,539,48397,50824
Uttar Pradesh,Etah,Indigenous(Desi),1503,65,1866,69,441,23,3967,9313,6876,14460,3993,524,227,35393,39360
Uttar Pradesh,Etawah,Exotic,1474,75,324,27,36,7,1943,10010,6434,18985,3526,820,439,40214,42157
Uttar Pradesh,Etawah,Indigenous(Desi),1497,83,603,73,54,31,2341,14308,11037,26184,5898,1538,1314,60279,62620
Uttar Pradesh,Faizabad,Exotic,2359,254,628,57,14,90,3402,12865,15697,13879,6449,1246,867,51003,54405
Uttar Pradesh,Faizabad,Indigenous(Desi),11318,628,8630,355,186,231,21348,49188,52685,57789,31877,4747,2487,198773,220121
Uttar Pradesh,Farrukhabad,Exotic,1448,136,619,88,72,17,2380,9346,6431,16450,5340,1082,330,38979,41359
Uttar Pradesh,Farrukhabad,Indigenous(Desi),1852,257,3684,232,378,57,6460,17739,15189,23546,8115,1605,652,66846,73306
Uttar Pradesh,Fatehpur,Exotic,1639,97,1057,192,69,87,3141,7615,4977,12260,4075,715,206,29848,32989
Uttar Pradesh,Fatehpur,Indigenous(Desi),8373,412,22946,803,334,532,33400,23641,18621,36904,14023,2172,1063,96424,129824
Uttar Pradesh,Firozabad,Exotic,2380,81,247,108,15,297,3128,21749,17822,39262,8254,1529,955,89571,92699
Uttar Pradesh,Firozabad,Indigenous(Desi),1711,93,1052,37,52,154,3099,17336,11607,30622,6104,2196,650,68515,71614
Uttar Pradesh,Gautam Buddha Nagar,Exotic,2326,326,899,133,686,123,4493,11127,6668,24696,3467,873,303,47134,51627
Uttar Pradesh,Gautam Buddha Nagar,Indigenous(Desi),2514,115,641,125,751,98,4244,7899,4915,16982,4079,856,265,34996,39240
Uttar Pradesh,Ghaziabad,Exotic,3149,396,1040,67,673,42,5367,17936,10868,38156,6601,935,417,74913,80280
Uttar Pradesh,Ghaziabad,Indigenous(Desi),768,159,454,11,469,39,1900,4320,1893,9521,1937,147,202,18020,19920
Uttar Pradesh,Ghazipur,Exotic,2867,72,58,35,21,177,3230,27154,27092,35473,16502,1559,728,108508,111738
Uttar Pradesh,Ghazipur,Indigenous(Desi),6047,203,689,166,84,213,7402,65878,68060,80565,42823,7017,2789,267132,274534
Uttar Pradesh,Gonda,Exotic,3287,343,718,174,88,135,4745,29782,20087,43346,15132,3258,1401,113006,117751
Uttar Pradesh,Gonda,Indigenous(Desi),10314,576,9122,335,913,446,21706,56824,48777,86180,37671,7308,2203,238963,260669
Uttar Pradesh,Gorakhpur,Exotic,5080,272,319,112,64,834,6681,46343,40978,69373,25326,3002,2161,187183,193864
Uttar Pradesh,Gorakhpur,Indigenous(Desi),2840,135,428,158,157,423,4141,24593,21433,27108,13711,1797,784,89426,93567
Uttar Pradesh,Hamirpur,Exotic,220,10,15,27,5,1,278,1800,882,2287,441,140,16,5566,5844
Uttar Pradesh,Hamirpur,Indigenous(Desi),6679,397,9310,574,2232,252,19444,37410,15766,46878,12420,2644,745,115863,135307
Uttar Pradesh,Hapur,Exotic,3969,68,2068,82,434,197,6818,14840,9391,30925,6621,666,190,62633,69451
Uttar Pradesh,Hapur,Indigenous(Desi),2174,71,1127,140,383,96,3991,6971,4795,13363,3212,259,73,28673,32664
Uttar Pradesh,Hardoi,Exotic,2694,499,2299,303,1233,558,7586,10193,7831,16721,5664,980,754,42143,49729
Uttar Pradesh,Hardoi,Indigenous(Desi),19737,4101,43585,2559,4200,2075,76257,65217,56850,114568,44809,6819,5747,294010,370267
Uttar Pradesh,Hathras,Exotic,1185,148,272,135,479,139,2358,12358,7302,22338,3781,1030,712,47521,49879
Uttar Pradesh,Hathras,Indigenous(Desi),2079,181,960,292,937,234,4683,17816,11523,30769,6898,1175,1704,69885,74568
Uttar Pradesh,Jalaun,Exotic,788,12,21,6,12,10,849,6086,3269,7428,1389,948,200,19320,20169
Uttar Pradesh,Jalaun,Indigenous(Desi),6997,524,1283,141,161,151,9257,53214,26076,74256,15409,4216,1601,174772,184029
Uttar Pradesh,Jaunpur,Exotic,7757,343,345,166,104,305,9020,42815,35069,65555,30880,5415,4051,183785,192805
Uttar Pradesh,Jaunpur,Indigenous(Desi),15177,1208,2976,580,181,586,20708,74226,65136,100328,65906,7889,9942,323427,344135
Uttar Pradesh,Jhansi,Exotic,212,19,22,8,59,55,375,2482,1692,2820,1024,209,83,8310,8685
Uttar Pradesh,Jhansi,Indigenous(Desi),7163,711,6103,997,3816,696,19486,57160,37273,69652,24826,7392,2315,198618,218104
Uttar Pradesh,Kannauj,Exotic,676,170,193,98,40,77,1254,9677,8009,15578,3240,413,548,37465,38719
Uttar Pradesh,Kannauj,Indigenous(Desi),4060,743,2380,426,464,498,8571,37701,47238,58874,31401,5327,6686,187227,195798
Uttar Pradesh,Kanpur Dehat,Exotic,2676,221,220,37,30,48,3232,12070,10141,20860,3662,545,370,47648,50880
Uttar Pradesh,Kanpur Dehat,Indigenous(Desi),4594,343,1677,277,185,212,7288,32075,25038,53387,9985,1697,881,123063,130351
Uttar Pradesh,Kanpur Nagar,Exotic,1736,142,234,18,36,529,2695,13009,7744,23255,5519,660,319,50506,53201
Uttar Pradesh,Kanpur Nagar,Indigenous(Desi),4366,211,2755,153,222,651,8358,27828,19035,51874,12974,1171,825,113707,122065
Uttar Pradesh,Kasganj,Exotic,851,59,1164,37,136,83,2330,3587,2309,5993,1907,470,157,14423,16753
Uttar Pradesh,Kasganj,Indigenous(Desi),3163,419,8444,699,4448,168,17341,12251,9001,18582,4726,613,399,45572,62913
Uttar Pradesh,Kaushambi,Exotic,3736,758,304,58,46,25,4927,9429,6762,13033,3711,336,269,33540,38467
Uttar Pradesh,Kaushambi,Indigenous(Desi),5438,1695,6501,1545,282,245,15706,32990,27630,41525,15206,2957,2014,122322,138028
Uttar Pradesh,Kheri,Exotic,5749,576,5622,398,391,139,12875,18664,16018,24887,12368,2005,1203,75145,88020
Uttar Pradesh,Kheri,Indigenous(Desi),24715,2597,40184,1804,6101,1142,76543,68502,69346,97827,49744,11903,6723,304045,380588
Uttar Pradesh,Kushi Nagar,Exotic,4409,94,390,110,103,199,5305,32356,19559,35475,14865,1275,630,104160,109465
Uttar Pradesh,Kushi Nagar,Indigenous(Desi),2034,99,1154,135,759,44,4225,15103,10838,16346,7916,669,662,51534,55759
Uttar Pradesh,Lalitpur,Exotic,63,17,11,8,2,2,103,2670,4592,2792,2351,406,196,13007,13110
Uttar Pradesh,Lalitpur,Indigenous(Desi),19118,2171,12492,864,288,296,35229,84537,65159,99061,59615,4606,3197,316175,351404
Uttar Pradesh,Lucknow,Exotic,2100,857,497,949,517,108,5028,13590,7771,22962,7503,1632,929,54387,59415
Uttar Pradesh,Lucknow,Indigenous(Desi),6062,1821,5981,530,1142,1246,16782,31864,23799,58441,18413,3665,1967,138149,154931
Uttar Pradesh,Maharajganj,Exotic,1735,180,269,114,100,99,2497,10606,6580,13456,6489,893,318,38342,40839
Uttar Pradesh,Maharajganj,Indigenous(Desi),976,120,1384,35,311,176,3002,6904,6147,7643,3773,569,225,25261,28263
Uttar Pradesh,Mahoba,Exotic,125,3,31,5,3,2,169,555,307,759,241,14,20,1896,2065
Uttar Pradesh,Mahoba,Indigenous(Desi),7091,186,13630,840,1693,209,23649,30713,17132,42738,18085,2016,2571,113255,136904
Uttar Pradesh,Mainpuri,Exotic,2402,233,645,98,99,137,3614,19355,14406,27165,6231,680,835,68672,72286
Uttar Pradesh,Mainpuri,Indigenous(Desi),2944,671,1737,143,231,330,6056,17631,11789,20472,6443,2156,2806,61297,67353
Uttar Pradesh,Mathura,Exotic,1811,144,527,87,334,43,2946,11479,7839,19963,6652,2646,2007,50586,53532
Uttar Pradesh,Mathura,Indigenous(Desi),8463,847,2405,457,2415,877,15464,36589,19247,65876,17442,2741,3345,145240,160704
Uttar Pradesh,Mau,Exotic,2354,81,75,15,14,48,2587,15340,11151,18213,8105,1302,866,54977,57564
Uttar Pradesh,Mau,Indigenous(Desi),3235,145,308,22,57,90,3857,30761,25488,33586,18125,1652,2271,111883,115740
Uttar Pradesh,Meerut,Exotic,7989,353,3149,437,775,191,12894,48208,26816,92352,12895,3858,1192,185321,198215
Uttar Pradesh,Meerut,Indigenous(Desi),2616,202,2248,158,344,68,5636,9508,6739,18998,3931,1227,331,40734,46370
Uttar Pradesh,Mirzapur,Exotic,4184,2264,2274,46,18,62,8848,46481,36391,73066,24309,3499,1360,185106,193954
Uttar Pradesh,Mirzapur,Indigenous(Desi),10771,2716,17885,1704,1051,1402,35529,66262,57465,96817,48283,7260,5618,281705,317234
Uttar Pradesh,Moradabad,Exotic,7185,989,5162,616,309,101,14362,16017,11306,29635,7712,1123,302,66095,80457
Uttar Pradesh,Moradabad,Indigenous(Desi),7999,669,8232,783,2212,121,20016,18241,15336,31735,8405,2163,581,76461,96477
Uttar Pradesh,Muzaffarnagar,Exotic,10187,352,3374,259,912,337,15421,52516,42182,100212,21842,2720,1818,221290,236711
Uttar Pradesh,Muzaffarnagar,Indigenous(Desi),2982,156,4620,237,716,115,8826,9836,10879,19467,4621,578,306,45687,54513
Uttar Pradesh,Pilibhit,Exotic,2088,75,597,50,141,143,3094,8124,6849,11685,3791,718,441,31608,34702
Uttar Pradesh,Pilibhit,Indigenous(Desi),9710,288,6088,301,458,519,17364,25984,25281,38288,14615,2793,1260,108221,125585
Uttar Pradesh,Pratapgarh,Exotic,3553,661,699,375,101,183,5572,31144,28401,38027,13366,4376,1911,117225,122797
Uttar Pradesh,Pratapgarh,Indigenous(Desi),13513,983,4975,915,459,626,21471,116226,100181,136428,64209,24630,18261,459935,481406
Uttar Pradesh,Rae Bareli,Exotic,3340,298,1092,50,73,104,4957,15342,12156,21602,10044,1675,1019,61838,66795
Uttar Pradesh,Rae Bareli,Indigenous(Desi),22804,1002,31038,1215,4094,627,60780,60894,47633,88751,53644,10380,2981,264283,325063
Uttar Pradesh,Rampur,Exotic,1961,115,577,67,322,101,3143,9420,6956,14069,3398,916,867,35626,38769
Uttar Pradesh,Rampur,Indigenous(Desi),3552,296,3025,744,953,448,9018,14056,12727,23378,5696,661,1791,58309,67327
Uttar Pradesh,Saharanpur,Exotic,7345,161,2095,202,477,93,10373,43533,26460,66403,21041,1239,1072,159748,170121
Uttar Pradesh,Saharanpur,Indigenous(Desi),3857,114,3885,189,530,402,8977,26014,14305,34075,11676,661,675,87406,96383
Uttar Pradesh,Sambhal,Exotic,3424,155,1019,199,259,36,5092,9164,5800,16240,3991,1316,197,36708,41800
Uttar Pradesh,Sambhal,Indigenous(Desi),11921,454,8569,743,7908,221,29816,24752,20960,41190,12689,2755,951,103297,133113
Uttar Pradesh,Sant Kabeer Nagar,Exotic,2533,658,1119,1080,54,89,5533,13053,11165,17008,6931,808,558,49523,55056
Uttar Pradesh,Sant Kabeer Nagar,Indigenous(Desi),1276,112,507,103,132,97,2227,6956,6569,9141,3569,298,192,26725,28952
Uttar Pradesh,Sant Ravidas Nagar,Exotic,893,66,100,33,6,13,1111,11952,9314,16440,7690,1553,750,47699,48810
Uttar Pradesh,Sant Ravidas Nagar,Indigenous(Desi),3996,232,858,83,21,97,5287,37276,38562,48908,24438,3543,5641,158368,163655
Uttar Pradesh,Shahjahanpur,Exotic,609,116,408,129,102,26,1390,3019,2643,5227,2433,838,350,14510,15900
Uttar Pradesh,Shahjahanpur,Indigenous(Desi),11282,1316,15945,2725,1982,787,34037,50192,44875,72497,37683,3797,2162,211206,245243
Uttar Pradesh,Shamli,Exotic,3849,50,918,63,368,47,5295,23309,13723,40509,12316,716,211,90784,96079
Uttar Pradesh,Shamli,Indigenous(Desi),1030,10,944,16,157,17,2174,5343,3116,8318,2700,125,36,19638,21812
Uttar Pradesh,Shravasti,Exotic,249,59,85,24,12,4,433,7307,1917,5215,1370,235,42,16086,16519
Uttar Pradesh,Shravasti,Indigenous(Desi),4890,2260,26801,879,625,1283,36738,26770,17914,42503,13454,3642,2502,106785,143523
Uttar Pradesh,Siddharth Nagar,Exotic,410,47,39,8,1,41,546,4187,3603,5394,878,613,178,14853,15399
Uttar Pradesh,Siddharth Nagar,Indigenous(Desi),2672,143,1049,89,48,246,4247,20991,23362,24123,5364,1660,1918,77418,81665
Uttar Pradesh,Sitapur,Exotic,1791,236,1423,163,129,154,3896,10541,7271,14378,4599,773,619,38181,42077
Uttar Pradesh,Sitapur,Indigenous(Desi),20095,1866,43925,2878,2708,1918,73390,91816,69114,121696,58336,6970,7332,355264,428654
Uttar Pradesh,Sonbhadra,Exotic,1559,99,611,32,4,18,2323,7384,5407,10415,3790,809,1063,28868,31191
Uttar Pradesh,Sonbhadra,Indigenous(Desi),42016,3720,110204,4701,811,2967,164419,83483,71994,109814,75838,8491,4839,354459,518878
Uttar Pradesh,Sultanpur,Exotic,4096,298,548,100,113,311,5466,30095,22716,44990,17546,2296,1483,119126,124592
Uttar Pradesh,Sultanpur,Indigenous(Desi),9801,1004,4703,439,348,554,16849,52096,52366,71747,31780,4172,6104,218265,235114
Uttar Pradesh,Unnao,Exotic,1387,199,1383,148,45,241,3403,9462,6490,14710,4018,792,382,35854,39257
Uttar Pradesh,Unnao,Indigenous(Desi),16058,2000,38446,2760,3099,1831,64194,54202,45776,80503,31711,5814,2728,220734,284928
Uttar Pradesh,Varanasi,Exotic,3550,556,519,323,304,455,5707,44562,33365,66858,20727,2853,2600,170965,176672
Uttar Pradesh,Varanasi,Indigenous(Desi),1607,261,426,152,117,151,2714,33040,29671,45630,13811,3193,2118,127463,130177
Uttarakhand,Almora,Exotic,814,31,210,30,7,45,1137,3732,2689,7447,1804,215,18,15905,17042
Uttarakhand,Almora,Indigenous(Desi),7969,518,42571,3616,186,592,55452,16997,12039,34792,11670,1011,77,76586,132038
Uttarakhand,Bageshwar,Exotic,294,2,93,0,0,7,396,1112,843,2340,556,61,10,4922,5318
Uttarakhand,Bageshwar,Indigenous(Desi),3149,250,26455,714,16,155,30739,8972,6065,16620,7850,539,78,40124,70863
Uttarakhand,Champawat,Exotic,940,25,1918,125,4,22,3034,9179,4834,14527,2181,366,59,31146,34180
Uttarakhand,Champawat,Indigenous(Desi),2147,202,11986,944,19,81,15379,7432,5381,12209,4450,598,57,30127,45506
Uttarakhand,Dehradun,Exotic,4017,484,1597,299,480,241,7118,21227,15664,48616,10142,2591,932,99172,106290
Uttarakhand,Dehradun,Indigenous(Desi),6487,370,20333,2626,325,130,30271,13728,8833,23601,8783,2090,447,57482,87753
Uttarakhand,Haridwar,Exotic,8292,154,2279,361,307,261,11654,24510,15627,49644,11466,1893,873,104013,115667
Uttarakhand,Haridwar,Indigenous(Desi),5438,413,5713,442,378,363,12747,10571,9321,21229,7765,1766,329,50981,63728
Uttarakhand,Nainital,Exotic,4381,158,798,77,44,128,5586,15989,11751,30901,8513,2045,712,69911,75497
Uttarakhand,Nainital,Indigenous(Desi),6797,556,23245,608,55,186,31447,16602,11540,28202,11120,1754,344,69562,101009
Uttarakhand,Pauri Garhwal,Exotic,1153,78,211,33,7,72,1554,5267,3197,8891,1709,210,71,19345,20899
Uttarakhand,Pauri Garhwal,Indigenous(Desi),14920,2352,26739,1502,803,1037,47353,51155,30905,69177,32287,3265,1270,188059,235412
Uttarakhand,Pithoragarh,Exotic,1573,80,2060,44,0,3,3760,13365,6000,24990,5263,978,96,50692,54452
Uttarakhand,Pithoragarh,Indigenous(Desi),5519,276,25482,982,17,18,32294,20568,9363,32581,11016,2281,314,76123,108417
Uttarakhand,Rudraprayag,Exotic,166,25,113,0,0,3,307,558,435,1276,291,92,1,2653,2960
Uttarakhand,Rudraprayag,Indigenous(Desi),3627,224,24839,44,8,44,28786,8875,7235,18179,7055,1069,78,42491,71277
Uttarakhand,Tehri Garhwal,Exotic,267,13,968,12,3,4,1267,1056,563,2061,502,63,17,4262,5529
Uttarakhand,Tehri Garhwal,Indigenous(Desi),3691,345,36029,435,176,142,40818,9158,4900,17200,7355,1153,249,40015,80833
Uttarakhand,Udham Singh Nagar,Exotic,5806,165,591,163,119,288,7132,21166,18944,41607,11112,2398,679,95906,103038
Uttarakhand,Udham Singh Nagar,Indigenous(Desi),5071,443,3137,280,933,412,10276,11154,13189,18031,8346,1405,910,53035,63311
Uttarakhand,Uttarkashi,Exotic,948,15,1365,13,0,18,2359,5965,2492,9094,2157,308,113,20129,22488
Uttarakhand,Uttarkashi,Indigenous(Desi),3689,82,38431,242,74,27,42545,10276,5763,14702,8625,683,397,40446,82991
Uttarakhand,chamoli,Exotic,406,57,488,25,0,77,1053,3114,2052,5776,1066,276,123,12407,13460
Uttarakhand,chamoli,Indigenous(Desi),6666,450,44224,1437,41,933,53751,17569,13191,34761,10629,1605,659,78414,132165
West Bengal,24 Paraganas North,Exotic,18071,2910,3879,952,952,1569,28333,58603,41887,79632,20818,4421,2583,207944,236277
West Bengal,24 Paraganas North,Indigenous(Desi),76675,7747,17797,3360,2677,8296,116552,102079,90756,93946,37758,12327,7906,344772,461324
West Bengal,24 Paraganas South,Exotic,8719,2015,1977,761,190,823,14485,19483,19418,24528,6985,2396,4313,77123,91608
West Bengal,24 Paraganas South,Indigenous(Desi),102774,12289,18343,5261,2835,16274,157776,203328,224909,185619,105127,31653,19475,770111,927887
West Bengal,Alipurduar,Exotic,906,172,162,69,39,78,1426,9708,9428,11448,3441,2080,1241,37346,38772
West Bengal,Alipurduar,Indigenous(Desi),30251,4427,27315,6806,1095,4763,74657,111418,103035,114601,49289,22014,6657,407014,481671
West Bengal,Bankura,Exotic,20497,2040,6603,691,1029,745,31605,57297,49227,72703,23611,10487,1630,214955,246560
West Bengal,Bankura,Indigenous(Desi),128414,14621,222023,8302,22625,8376,404361,206063,193793,267825,113849,48270,11110,840910,1245271
West Bengal,Bardhaman,Exotic,25276,1748,4942,685,777,951,34379,97454,76002,126352,39745,13827,3157,356537,390916
West Bengal,Bardhaman,Indigenous(Desi),94818,7968,52711,4071,4655,2878,167101,275204,233042,323129,97801,34134,11342,974652,1141753
West Bengal,Birbhum,Exotic,7322,301,2395,152,126,224,10520,26814,23286,33873,12866,4892,1184,102915,113435
West Bengal,Birbhum,Indigenous(Desi),129256,14314,154960,11754,9242,10540,330066,203449,172261,230232,90697,32568,12625,741832,1071898
West Bengal,Coochbehar,Exotic,4294,935,1501,549,431,630,8340,24515,25447,31083,13594,4913,3690,103242,111582
West Bengal,Coochbehar,Indigenous(Desi),82413,14549,77433,12324,3612,5702,196033,232415,247763,253466,123888,38635,22888,919055,1115088
West Bengal,Darjeeling,Exotic,6098,1887,2988,1634,1334,1787,15728,13434,8870,17656,5888,3272,1423,50543,66271
West Bengal,Darjeeling,Indigenous(Desi),10974,856,9253,857,383,356,22679,35781,25499,37010,11119,3778,1744,114931,137610
West Bengal,Dinajpur Dakshin,Exotic,1791,145,416,58,24,29,2463,5588,5257,6376,2927,834,205,21187,23650
West Bengal,Dinajpur Dakshin,Indigenous(Desi),56125,5159,47858,4616,2935,3006,119699,99598,108939,103076,59585,14029,3480,388707,508406
West Bengal,Dinajpur Uttar,Exotic,3285,300,800,109,96,364,4954,18397,13437,21341,6292,2214,1219,62900,67854
West Bengal,Dinajpur Uttar,Indigenous(Desi),82751,16764,87287,14043,5291,6419,212555,222308,208294,233865,104921,28939,12854,811181,1023736
West Bengal,Hooghly,Exotic,17263,1069,2917,391,227,642,22509,63087,44891,95729,24579,8896,2524,239706,262215
West Bengal,Hooghly,Indigenous(Desi),80706,3349,59239,1143,1584,3415,149436,135922,105950,181134,54424,18895,4769,501094,650530
West Bengal,Howrah,Exotic,3817,207,141,103,17,125,4410,13576,11627,21363,6894,2731,1198,57389,61799
West Bengal,Howrah,Indigenous(Desi),10712,1029,1054,415,208,480,13898,36773,34433,50297,20504,5958,2726,150691,164589
West Bengal,Jalpaiguri,Exotic,4075,390,1222,341,212,566,6806,14644,8150,17141,6851,2915,1024,50725,57531
West Bengal,Jalpaiguri,Indigenous(Desi),66951,7736,72630,9134,1983,5995,164429,129827,120370,149175,75162,21294,9804,505632,670061
West Bengal,Jhargram,Exotic,2625,1263,1913,342,221,306,6670,10106,7503,11411,4187,985,412,34604,41274
West Bengal,Jhargram,Indigenous(Desi),48539,8726,103631,7731,12931,6468,188026,88167,79407,99705,49290,10695,6927,334191,522217
West Bengal,KALIMPONG,Exotic,3633,470,5621,394,130,152,10400,9354,6511,14087,4669,1724,541,36886,47286
West Bengal,KALIMPONG,Indigenous(Desi),75,21,15,2,0,124,237,377,60,482,304,105,64,1392,1629
West Bengal,Kolkata,Exotic,6,2,3,0,2,1,14,47,40,224,15,12,5,343,357
West Bengal,Kolkata,Indigenous(Desi),63,6,12,3,5,87,176,85,81,230,42,21,11,470,646
West Bengal,Maldah,Exotic,10148,2729,3247,946,565,923,18558,30197,26984,30864,9188,3749,1727,102709,121267
West Bengal,Maldah,Indigenous(Desi),89169,18347,79395,12635,8096,7737,215379,203217,182467,193371,83562,28674,10826,702117,917496
West Bengal,Medinipur East,Exotic,15207,667,529,222,124,462,17211,56843,51979,61726,23176,6803,2296,202823,220034
West Bengal,Medinipur East,Indigenous(Desi),67946,4921,5602,1697,704,3391,84261,219037,215071,227512,93342,25325,8917,789204,873465
West Bengal,Medinipur West,Exotic,27054,1582,7133,628,1377,824,38598,89199,75940,110079,43999,16843,4976,341036,379634
West Bengal,Medinipur West,Indigenous(Desi),124476,13101,117189,7837,14635,9534,286772,289143,269636,329815,147415,42395,13633,1092037,1378809
West Bengal,Murshidabad,Exotic,33803,3926,7128,1455,1572,1418,49302,96533,70523,118549,32151,12768,6725,337249,386551
West Bengal,Murshidabad,Indigenous(Desi),143757,15473,31443,5434,5151,7993,209251,184586,151793,188564,53915,17136,8021,604015,813266
West Bengal,Nadia,Exotic,28024,2153,8077,1604,1043,1288,42189,95472,66470,112680,35399,9767,3099,322887,365076
West Bengal,Nadia,Indigenous(Desi),52708,4652,20767,2712,1628,2629,85096,105840,91031,114604,38286,11267,5580,366608,451704
West Bengal,PASCHIM BARDHAMAN,Exotic,1906,205,326,86,924,185,3632,11035,5555,18106,4622,1964,214,41496,45128
West Bengal,PASCHIM BARDHAMAN,Indigenous(Desi),18863,1262,18644,1209,2571,1181,43730,52650,34767,65350,22131,8097,1784,184779,228509
West Bengal,Purulia,Exotic,1372,275,728,224,335,236,3170,3713,2597,6145,1461,647,342,14905,18075
West Bengal,Purulia,Indigenous(Desi),76292,14435,366207,11247,23886,9535,501602,95903,83206,124112,63365,20918,8093,395597,897199